CK Hutchison Holdings Limited;CK Hutchison	长和
CLP Holdings Ltd.;CLP Holdings	中电控股
The Hong Kong and China Gas Co. Ltd.;Hong Kong and China Gas	香港中华煤气
The Wharf (Holdings) Limited;Wharf Limited;Wharf	九龙仓集团
HSBC Holdings Plc;HSBC Holdings Plc;HSBC	汇丰控股
Power Assets Holdings Limited;Power Assets	电能实业
Hong Kong Finance Investment Holding Group Limited;Hong Kong Finance Investment;Hong Kong Finance	香港金融集团
PCCW Ltd.;PCCW	电讯盈科
Nine Express Limited;Nine Express	九号运通
Hang Lung Group Ltd.;Hang Lung	恒隆集团
Hang Seng Bank Ltd.;Hang Seng Bank	恒生银行
Henderson Land Development Co. Ltd.;Henderson Land Development	恒基地产
Hysan Development Co. Ltd.;Hysan Development	希慎兴业
Vantage International (Holdings) Ltd.;Vantage International	盈信控股
Sun Hung Kai Properties Ltd.;Sun Hung Kai Properties	新鸿基地产
New World Development Co. Ltd.;New World Development	新世界发展
Oriental Press Group Ltd.;Oriental Press	东方报业集团
Swire Pacific Ltd.;Swire Pacific	太古股份公司A
Wheelock and Co. Ltd.;Wheelock	会德丰
Great China Properties Holdings Limited;Great China Properties	大中华地产控股
Mexan Limited;Mexan	茂盛控股
The Bank of East Asia, Limited;Bank of East Asia;BEA	东亚银行
Burwill Holdings Ltd.;Burwill	宝威控股
Chevalier International Holdings Ltd.;Chevalier International	CHEVALIER INT'L
China Motor Bus Co., Ltd.;China Motor Bus	中华汽车
Galaxy Entertainment Group Limited;Galaxy Entertainment	银河娱乐
Tian An China Investments Co. Ltd.;Tian An China Investments;TianAn;Tian An	天安
Dynamic Holdings Ltd.;Dynamic Holdings	达力集团
Ban Loong Holdings Limited;Ban Loong	万隆控股集团
China Aerospace International Holdings Ltd.;China Aerospace	航天控股
The Cross-Harbour (Holdings) Ltd.;Cross-Harbour	港通控股
Asia Investment Finance Group Limited;Asia Investment Finance	亚投金融集团
Kowloon Development Company Limited;Kowloon Development	九龙建业
Far East Consortium International Ltd.;Far East Consortium	远东发展
Far East Holdings International Limited;Far East	远东控股国际
Far East Hotels & Entertainment Ltd.;Far East Hotels & Entertainment;Far East Hotels	远东酒店实业
First Tractor Company Limited;First Tractor	第一拖拉机股份
China Beidahuang Industry Group Holdings Limited;China Beidahuang Industry;Beidahuang	中国北大荒
Gold Peak Industries (Holdings) Ltd.;Gold Peak Industries;Gold Peak	金山工业
Great Eagle Holdings Limited;Great Eagle	鹰君
Northeast Electric Development Company Limited;Northeast Electric Development;Northeast Electric	东北电气
C. P. Pokphand Co. Ltd.;C. P. Pokphand	卜蜂国际
Hong Kong Aircraft Engineering Co. Ltd.;Hong Kong Aircraft Engineering	香港飞机工程
The Hongkong and Shanghai Hotels, Ltd.;Hongkong and Shanghai Hotels	大酒店
Computer and Technologies Holdings Ltd.;Computer and Technologies	科联系统
Hop Hing Group Holdings Ltd.;Hop Hing;HopHing	合兴集团
China Automotive Interior Decoration Holdings Limited;China Automotive Interior Decoration	中国汽车内饰
Hong Kong Ferry (Holdings) Co. Ltd.;Hong Kong Ferry	香港小轮(集团)
Harbour Centre Development Ltd.;Harbour Centre Development	海港企业
Fairwood Holdings Ltd.;Fairwood	大快活
Guoco Group Ltd.;Guoco	国浩集团
Hopewell Holdings Ltd.;Hopewell	合和实业
Neway Group Holdings Limited;Neway	中星集团控股
Allied Properties (HK) Ltd.;Allied Properties	联合地产(香港)
Chen Hsong Holdings Ltd.;Chen Hsong	震雄集团
Sunway International Holdings Ltd.;Sunway	新威国际
Skyfame Realty (Holdings) Limited;Skyfame Realty;Skyfame	天誉置业
Hong Kong Food Investment Holdings Limited;Hong Kong Food Investment;Hong Kong Food	香港食品投资
Green Leader Holdings Group Limited;Green Leader	绿领控股
Transport International Holdings Limited;Transport International	载通
China Graphene Group Limited;China Graphene	中国烯谷集团
Get Nice Holdings Ltd.;Get Nice	结好控股
Grand Ocean Advanced Resources Company Limited;Grand Ocean Advanced Resources	弘海高新资源
MTR Corporation Ltd.;MTR	港铁公司
China Lumena New Materials Corp.;China Lumena New Materials	旭光高新材料
Lee Hing Development Ltd.;Lee Hing Development;Lee Hing	利兴发展
Shangri-La Asia Ltd.;Shangri-La Asia	香格里拉(亚洲)
Rich Goldman Holdings Limited;Rich Goldman	金粤控股
Miramar Hotel & Investment Co. Ltd.;Miramar Hotel & Investment;Miramar	美丽华酒店
Modern Media Holdings Limited;Modern Media	现代传播
Asian Citrus Holdings Limited;Asian Citrus	亚洲果业
Y. T. Realty Group Ltd.;Y. T. Realty	渝太地产
South Sea Petroleum Holdings Ltd.;South Sea Petroleum	南海石油
AMS Public Transport Holdings Ltd.;AMS Public Transport	进智公共交通
Regal Hotels International Holdings Ltd.;Regal Hotels	REGAL INT'L
Century Legend (Holdings) Ltd.;Century Legend	世纪建业
China New Economy Fund Limited;China New Economy Fund	中国新经济投资
China Overseas Grand Oceans Group Limited;China Overseas Grand Oceans	中国海外宏洋集团
V1 Group Limited;V1 Group	第一视频
Sino Land Co. Ltd.;Sino Land	信和置业
Stelux Holdings International Ltd.;Stelux	宝光实业
China Electronics Huada Technology Company Limited;China Electronics Huada Technology	中电华大科技
Sun Hung Kai & Co. Ltd.;Sun Hung Kai;SHK	新鸿基公司
Swire Pacific Ltd.;Swire Pacific	太古股份公司B
Tai Cheung Holdings Ltd.;Tai Cheung	TAI CHEUNG HOLD
Tai Sang Land Development Ltd.;Tai Sang Land Development;Tai Sang;TaiSang	大生地产
Amber Energy Limited;Amber Energy	琥珀能源
International Standard Resources Holdings Limited;International Standard Resources	标准资源控股
Champion Technology Holdings Ltd.;Champion Technology	CHAMPION TECH
Termbray Industries International (Holdings) Ltd.;Termbray Industries International;Termbray	TERMBRAY IND
Greenheart Group Limited;Greenheart	绿心集团
LVGEM (China) Real Estate Investment Company Limited;LVGEM (China) Real Estate Investment;LVGEM Real Estate	绿景中国地产
Yusei Holdings Limited;Yusei Holdings;Yusei	YUSEI
Henderson Investment Ltd.;Henderson Investment	恒基发展
Xingfa Aluminium Holdings Ltd;Xingfa Aluminium	兴发铝业
Wong's International Holdings Limited;Wong's	王氏国际
Clear Media Ltd.;Clear Media	白马户外媒体
Hang Lung Properties Ltd.;Hang Lung Properties	恒隆地产
Summit Ascent Holdings Limited;Summit Ascent	凯升控股
Shougang Concord Century Holdings Ltd.;Shougang Concord Century	首长宝佳
Asia Commercial Holdings Ltd.;Asia Commercial	ASIA COMM HOLD
Associated International Hotels Ltd.;Associated International Hotels	凯联国际酒店
Landsea Green Group Co., Ltd.;Landsea Green	朗诗绿色集团
Sichuan Expressway Company Limited;Sichuan Expressway	四川成渝高速公路
GR Properties Limited;GR Properties	国锐地产
Good Resources Holdings Limited;Good Resources	天成国际
China Fortune Holdings Limited;China Fortune	中国长远
Cinda International Holdings Limited;Cinda International	信达国际控股
LT Commercial Real Estate Limited;LT Commercial Real Estate	勒泰商业地产
Dickson Concepts (International) Ltd.;Dickson Concepts	迪生创建
Herald Holdings Ltd.;Herald	HERALD HOLD
Grand Field Group Holdings Ltd.;Grand Field	钧濠集团
Chow Sang Sang Holdings International Ltd.;Chow Sang Sang	周生生
Tianli Holdings Group Limited;Tianli Holdings	天利控股集团
Cosmos Machinery Enterprises Ltd.;Cosmos Machinery Enterprises;Cosmos Machinery	大同机械
Poly Property Group Co.,Limited;Poly Property Group Co.,Limited;Poly Property	保利置业集团
Cosmopolitan International Holdings Ltd.;Cosmopolitan	COSMOPOL INT'L
C.P. Lotus Corporation;C.P. Lotus	卜蜂莲花
Crocodile Garments Ltd.;Crocodile Garments	鳄鱼恤
Yuexiu Property Company Limited;Yuexiu Property	越秀地产
Guangdong Land Holdings Limited;Guangdong Land	粤海置地
Sun Hing Vision Group Holdings Ltd.;Sun Hing Vision	新兴光学
Carrianna Group Holdings Company Limited;Carrianna	佳宁娜
Chinese Estates Holdings Ltd.;Chinese Estates	华人置业
ENM Holdings Limited;ENM Holdings;ENM	安宁控股
Asia Standard International Group Ltd.;Asia Standard	泛海集团
Moiselle International Holdings Ltd;Moiselle	慕诗国际
Cheuk Nang (Holdings) Ltd.;Cheuk Nang	卓能(集团)
China Investments Holdings Limited;China Investments	中国兴业控股
China Merchants China Direct Investments Ltd.;China Merchants China Direct Investments	招商局中国基金
Kunlun Energy Company Limited;Kunlun Energy	昆仑能源
HengTen Networks Group Limited;HengTen Networks	恒腾网络
Jinhui Holdings Co. Ltd.;Jinhui	金辉集团
CCT Fortis Holdings Limited;CCT Fortis	中建富通
China Soft Power Technology Holdings Limited;China Soft Power Technology;China Soft Power	中国软实力
Great China Holdings Ltd.;Great China Holdings	大中华集团
First Pacific Co. Ltd.;First Pacific	第一太平
Guoan International Limited;Guoan	国安国际
China Merchants Port Holdings Company Limited;China Merchants Port	招商局港口
The Hong Kong Building and Loan Agency Ltd.;Hong Kong Building and Loan Agency	香港建屋贷款
Tai Ping Carpets International Ltd.;Tai Ping Carpets	TAI PING CARPET
International Business Settlement Holdings Limited;International Business Settlement	国际商业结算
Kingboard Holdings Limited;Kingboard	建滔集团
China Agri-Products Exchange Limited;China Agri-Products Exchange	中国农产品交易
Want Want China Holdings Limited;Want Want China;Want Want	中国旺旺
Shenzhen International Holdings Limited;Shenzhen International	深圳国际
China Saite Group Company Limited;China Saite	中国赛特
Beijing Enterprises Environment Group Limited;Beijing Enterprises Environment	北京控股环境集团
China Solar Energy Holdings Limited;China Solar Energy	中国源畅
Lippo China Resources Ltd.;Lippo China Resources	力宝华润
Natural Beauty Bio-Technology Ltd.;Natural Beauty Bio-Technology;Natural Beauty	自然美
Melbourne Enterprises Ltd.;Melbourne Enterprises	万邦投资
Brockman Mining Limited;Brockman Mining	布莱克万矿业
Hon Kwok Land Investment Company, Limited;Hon Kwok Land Investment;Hon Kwok Land	汉国置业
AVIC International Holdings Limited;AVIC	中航国际控股
Century Ginwa Retail Holdings Limited;Century Ginwa Retail	世纪金花
Emperor International Holdings Ltd.;Emperor	英皇国际
China Baoli Technologies Holdings Limited;China Baoli Technologies	中国宝力科技
China Everbright Ltd.;China Everbright	中国光大控股
New Times Energy Corporation Limited;New Times Energy	新时代能源
IDT International Ltd.;IDT International	IDT INT'L
Tsingtao Brewery Company Limited;Tsingtao Brewery	青岛啤酒股份
Wanda Hotel Development Company Limited;Wanda Hotel Development;Wanda Hotel	万达酒店发展
Silver Grant International Industries Ltd.;Silver Grant International Industries	银建国际
Goldbond Group Holdings Ltd.;Goldbond	金榜集团
K. Wah International Holdings Ltd.;K. Wah	嘉华国际
Gemini Investments (Holdings) Limited;Gemini Investments	盛洋投资
Geely Automobile Holdings Limited;Geely Automobile;Geely	吉利汽车
Superactive Group Company Limited;Superactive	先机企业集团
Jiangsu Expressway Company Limited;Jiangsu Expressway	江苏宁沪高速公路
Sa Sa International Holdings Ltd.;SaSa	莎莎国际
Johnson Electric Holdings Ltd.;Johnson Electric	德昌电机控股
Kader Holdings Company Limited;Kader	开达集团
Fujian Holdings Limited;Fujian Holdings	闽港控股
Concord New Energy Group Limited;Concord New Energy	协合新能源
Winfull Group Holdings Limited;Winfull	宏辉集团
Keck Seng Investments (Hong Kong) Ltd.;Keck Seng Investments	激成投资
ZH International Holdings Limited;ZH International	正恒国际控股
Nimble Holdings Company Limited;Nimble	敏捷控股
Beijing Jingcheng Machinery Electric Company Limited;Beijing Jingcheng Machinery Electric;Jingcheng Machinery Electric	京城机电股份
Sunwah Kingsway Capital Holdings Limited;Sunwah Kingsway Capital	新华汇富金融
Dongyue Group Limited;Dongyue	东岳集团
HKC (Holdings) Limited;HKC Holdings;HKC	香港建设(控股)
Lai Sun Garment (International) Ltd.;Lai Sun Garment	丽新国际
Capital Estate Ltd.;Capital Estate	冠中地产
Liu Chong Hing Investment Ltd.;Liu Chong Hing Investment;Liu Chong Hing	廖创兴企业
Greentech Technology International Limited;Greentech Technology	绿科科技国际
Honghua Group Limited;Honghua	宏华集团
Heng Tai Consumables Group Ltd;Heng Tai Consumables;Heng Tai	亨泰
SMI Holdings Group Limited;SMI Holdings;SMI	星美控股
ITC Properties Group Limited;ITC Properties;ITC	德祥地产
Melco International Development Ltd.;Melco International Development;Melco International	新濠国际发展
Magnificent Hotel Investments Limited;Magnificent Hotel Investments;Magnificent Hotel	华大酒店
EverChina Int'l Holdings Company Limited;EverChina Int'l	润中国际控股
China Investment Development Limited;China Investment Development	中国投资开发
SEEC Media Group Limited;SEEC Media	财讯传媒
TSC Group Holdings Limited;TSC Group;TSC	TSC集团
Joy City Property Limited;Joy City Property	大悦城地产
Polytec Asset Holdings Limited;Polytec Asset	保利达资产
Winshine Science Company Limited;Winshine Science	瀛晟科学
Daphne International Holdings Limited;Daphne	达芙妮国际
Styland Holdings Ltd.;Styland	STYLAND HOLD
Nanyang Holdings Limited;Nanyang	NANYANG HOLD
National Electronics Holdings Ltd.;National Electronics	NATIONAL ELEC H
Asia Orient Holdings Ltd.;Asia Orient	汇汉控股
Hutchison Telecommunications Hong Kong Holdings Limited;Hutchison Telecommunications Hong Kong;Hutchison Telecommunications	和记电讯香港
Chinney Investments, Ltd.;Chinney Investments	建业实业
China ChengTong Development Group Limited;China ChengTong Development;China ChengTong	中国诚通发展集团
Shenwan Hongyuan (H.K.) Limited;Shenwan Hongyuan	申万宏源
Shun Ho Property Investments Limited;Shun Ho Property Investments;Shun Ho Property	顺豪物业
Uni-President China Holdings LTD.;Uni-President China;Uni-President	统一企业中国
Easy One Financial Group Limited;Easy One Financial	易易壹金融
Min Xin Holdings Ltd.;Min Xin	闽信集团
Elife Holdings Limited;Elife	易生活控股
Pioneer Global Group Ltd.;Pioneer Global	建生国际
Pokfulam Development Co. Ltd.;Pokfulam Development;Pokfulam	博富临置业
Lippo Ltd.;Lippo	力宝
First Shanghai Investments Ltd.;First Shanghai Investments;First Shanghai	第一上海
China Energy Development Holdings Limited;China Energy Development;China Energy	中能控股
Raymond Industrial Ltd.;Raymond Industrial	利民实业
Minmetals Land Limited;Minmetals Land	五矿地产
Ping An Securities Group (Holdings) Limited;Ping An Securities	平安证券集团控股
AVIC International Holding (HK) Limited;AVIC International Holding;AVIC International	中国航空工业国际
Mingyuan Medicare Development Company Limited;Mingyuan Medicare Development;Mingyuan Medicare	铭源医疗
New Century Group Hong Kong Ltd.;New Century Group Hong Kong;New Century Group	新世纪集团
China Strategic Holdings Ltd.;China Strategic	中策集团
San Miguel Brewery Hong Kong Ltd.;San Miguel Brewery Hong Kong;San Miguel Brewery	香港生力啤
Safety Godown Co. Ltd.;Safety Godown	安全货仓
Evergreen International Holdings Limited;Evergreen	长兴国际
Pak Fah Yeow International Ltd.;Pak Fah Yeow	白花油
Build King Holdings Limited;Build King	利基控股
Alibaba Health Information Technology Limited;Alibaba Health Information Technology	阿里健康
Shun Tak Holdings Ltd.;Shun Tak	信德集团
QPL International Holdings Ltd.;QPL International	QPL INT'L
The Sincere Co. Ltd.;Sincere	先施
China Minsheng Financial Holding Corporation Limited;China Minsheng Financial Holding;China Minsheng Financial	中国民生金融
Real Gold Mining Ltd;Real Gold Mining	瑞金矿业
Tsim Sha Tsui Properties Ltd.;Tsim Sha Tsui Properties;Tsim Sha Tsui	TST PROPERTIES
HKC International Holdings Ltd.;HKC International;HKC	香港通讯国际控股
Sino-i Technology Ltd.;Sino-i Technology	中国数码信息
S E A Holdings Ltd.;S E A	爪哇控股
Southeast Asia Properties & Finance Ltd.;Southeast Asia Properties & Finance	华信地产财务
Shun Ho Holdings Limited;Shun Ho	顺豪控股
National United Resources Holdings Limited;National United Resources	国家联合资源
Lung Kee (Bermuda) Holdings Limited;Lung Kee (Bermuda);Lung Kee	龙记集团
Citychamp Watch & Jewellery Group Limited;Citychamp Watch & Jewellery	冠城钟表珠宝
China Everbright International Ltd.;China Everbright	中国光大国际
Tomson Group Ltd.;Tomson Group;Tomson	汤臣集团
Yeebo (International Holdings) Ltd.;Yeebo	亿都(国际控股)
AVIC Joy Holdings (HK) Limited;AVIC Joy Holdings;AVIC Joy	幸福控股
CCT Land Holdings Limited;CCT Land	中建置地
Deson Development International Holdings Ltd.;Deson Development	迪臣发展国际
GT Group Holdings Limited;GT Group	高富集团控股
Ascent International Holdings Limited;Ascent International	中玺国际
Orient Victory Travel Group Company Limited;Orient Victory Travel	东胜旅游
Tian Teck Land Ltd.;Tian Teck Land	天德地产
CITIC Limited;CITIC	中信股份
Kingdee International Software Group Co. Ltd.;Kingdee International Software	金蝶国际
China Resources and Transportation Group Limited;China Resources and Transportation	中国资源交通
Guangdong Investment Ltd.;Guangdong Investment	粤海投资
Asiasec Properties Limited;Asiasec Properties	亚证地产
Shui On Land Limited;Shui On Land;Shui On	瑞安房地产
Mason Group Holdings Limited;Mason	茂宸集团
China Billion Resources Limited;China Billion Resources	中富资源
Master Glory Group Limited;Master Glory	凯华集团
Mongolia Energy Corporation Limited;Mongolia Energy	蒙古能源
Tern Properties Co. Ltd.;Tern Properties	太兴置业
Wah Ha Realty Co. Ltd.;Wah Ha Realty	华厦置业
Freeman FinTech Corporation Limited;Freeman FinTech	民众金融科技
King Fook Holdings Ltd.;King Fook	景福集团
Rivera (Holdings) Ltd.;Rivera Holdings;Rivera	川河集团
Next Digital Limited;Next Digital	壹传媒
BYD Electronic (International) Company Limited;BYD Electronic;BYD	比亚迪电子
Common Splendor International Health Industry Group Limited;Common Splendor International Health Industry	同佳健康
Winfair Investment Co. Ltd.;Winfair Investment;Winfair	永发置业
WH Group Limited;WH Group	万洲国际
Wing On Company International Ltd.;Wing On	WING ON CO
China Fortune Financial Group Limited;China Fortune Financial	中国富强金融
China Resources Beer (Holdings) Company Limited;China Resources Beer	华润啤酒
Asia Standard Hotel Group Ltd.;Asia Standard Hotel	泛海酒店
Cathay Pacific Airways Ltd.;Cathay Pacific Airways	国泰航空
Yangtzekiang Garment Limited;Yangtzekiang Garment	长江制衣
Kong Sun Holdings Ltd.;Kong Sun	江山控股
Emperor Entertainment Hotel Limited;Emperor Entertainment Hotel	英皇娱乐酒店
Sinofert Holdings Limited;Sinofert	中化化肥
Chuang's China Investments Ltd.;Chuang's China Investments	庄士中国
New Sports Group Limited;New Sports	新体育
Shenji Group Kunming Machine Tool Company Limited;Shenji Group Kunming Machine Tool	昆明机床
VTech Holdings Ltd.;VTech	VTECH HOLDINGS
Wuling Motors Holdings Limited;Wuling Motors	五菱汽车
Kwoon Chung Bus Holdings Ltd.;Kwoon Chung Bus	冠忠巴士集团
Up Energy Development Group Limited;Up Energy Development	优派能源发展
China Travel International Investment Hong Kong Ltd.;China Travel International Investment Hong Kong;China Travel International Investment	香港中旅
Xinhua News Media Holdings Limited;Xinhua News Media	新华通讯频媒
Prosperity Investment Holdings Limited;Prosperity Investment	嘉进投资国际
Luen Thai Holdings Ltd.;Luen Thai	联泰控股
Shirble Department Store Holdings (China) Ltd;Shirble Department Store Holdings;Shirble Department Store	岁宝百货
Richly Field China Development Limited;Richly Field China Development;Richly Field China	裕田中国
SmarTone Telecommunications Holdings Ltd.;SmarTone Telecommunications	数码通电讯
Orient Overseas (International) Ltd.;Orient Overseas	东方海外国际
CSSC Offshore & Marine Engineering (Group) Company Limited;CSSC Offshore & Marine Engineering	中船防务
Vongroup Limited;Vongroup	黄河实业
Computime Group Limited;Computime	金宝通
Texwinca Holdings Ltd.;Texwinca	德永佳集团
Tingyi (Cayman Islands) Holdings Corp.;Tingyi (Cayman Islands) Holdings;Tingyi	康师傅控股
Maanshan Iron & Steel Company Limited;Maanshan Iron & Steel	马鞍山钢铁股份
China Star Entertainment Ltd.;China Star Entertainment;China Star	中国星集团
PAX Global Technology Limited;PAX Global Technology;PAX Global	百富环球
Alco Holdings Limited;Alco	ALCO HOLDINGS
OCI International Holdings Limited;OCI International	东建国际
Esprit Holdings Ltd.;Esprit Holdings;Esprit	思捷环球
FSE Services Group Limited;FSE Services	丰盛服务集团
Yuan Heng Gas Holdings Limited;Yuan Heng Gas	元亨燃气
Top Form International Ltd.;Top Form	黛丽斯国际
China Display Optoelectronics Technology Holdings Limited;China Display Optoelectronics Technology	华显光电
Upbest Group Ltd.;Upbest Group;Upbest	美建集团
Huabao International Holdings Ltd.;Huabao	华宝国际
Greenland Hong Kong Holdings Limited;Greenland Hong Kong	绿地香港
Sinopec Shanghai Petrochemical Company Limited;Sinopec Shanghai Petrochemical	上海石油化工股份
Core Economy Investment Group Limited;Core Economy Investment	核心经济投资
Tongguan Gold Group Limited;Tongguan Gold	潼关黄金
Cafe De Coral Holdings Ltd.;Cafe De Coral	大家乐集团
NewOcean Energy Holdings Ltd.;NewOcean Energy	新海能源
Culturecom Holdings Ltd.;Culturecom	文化传信
Vitasoy International Holdings Ltd.;Vitasoy	VITASOY INT'L
Yanchang Petroleum International Limited;Yanchang Petroleum	延长石油国际
Angang Steel Company Limited;Angang Steel	鞍钢股份
China Healthwise Holdings Limited;China Healthwise	中国智能健康
Asia Energy Logistics Group Limited;Asia Energy Logistics	亚洲能源物流
Fortune Sun (China) Holdings Ltd;Fortune Sun	富阳
Energy International Investments Holdings Limited;Energy International Investments	能源国际投资
Chinasoft International Ltd.;Chinasoft	中国软件国际
Century City International Holdings Ltd.;Century City	世纪城市国际
DT Capital Limited;DT Capital	鼎立资本
Regal International Airport Group Company Limited;Regal International Airport	瑞港集团
Jiangxi Copper Company Limited;Jiangxi Copper	江西铜业股份
China Haisheng Juice Holdings Co., Limited;China Haisheng Juice Holdings;Haisheng Juice	海升果汁
New Focus Auto Tech Holdings Ltd.;New Focus Auto Tech;New Focus	新焦点
Sino Golf Holdings Ltd.;Sino Golf	顺龙控股
China Zenith Chemical Group Limited;China Zenith Chemical	中国天化工
Shanghai Industrial Holdings Ltd.;Shanghai Industrial	上海实业控股
Blockchain Group Company Limited;Blockchain	区块链集团
Unisplendour Technology (Holdings) Limited;Unisplendour Technology;Unisplendour	紫光控股
Luks Group (Vietnam Holdings) Company Limited;Luks Group (Vietnam Holdings);Luks Group	陆氏集团(越南)
Chuang's Consortium International Ltd.;Chuang's Consortium	庄士机构国际
Sinotrans Shipping Limited;Sinotrans Shipping	中外运航运
Wing Tai Properties Limited;Wing Tai Properties;Wing Tai	永泰地产
China Best Group Holding Limited;China Best	国华
Beijing Enterprises Water Group Limited;Beijing Enterprises Water	北控水务集团
PT International Development Corporation Limited;PT International Development	保德国际发展
Allied Group Ltd.;Allied Group	联合集团
Four Seas Mercantile Holdings Ltd.;Four Seas Mercantile	四洲集团
YGM Trading Ltd.;YGM Trading	YGM TRADING
Yunfeng Financial Group Limited;Yunfeng Financial	云锋金融
Huajun International Group Limited;Huajun	华君国际集团
FDG Kinetic Limited;FDG Kinetic	五龙动力
China Ever Grand Financial Leasing Group Co., Ltd.;China Ever Grand Financial Leasing	恒嘉融资租赁
Softpower International Limited;Softpower	冠力国际
Kiu Hung International Holdings Limited;Kiu Hung	侨雄国际
China Medical & HealthCare Group Limited;China Medical & HealthCare	中国医疗网络
China Gas Holdings Ltd.;China Gas	中国燃气
Chinney Alliance Group Ltd.;Chinney Alliance	建联集团
China Petroleum & Chemical Corporation;China Petroleum & Chemical	中国石油化工股份
Leeport (Holdings) Ltd.;Leeport	力丰(集团)
Hong Kong Exchanges and Clearing Ltd.;Hong Kong Exchanges and Clearing	香港交易所
China Tontine Wines Group Limited;China Tontine Wines;Tontine Wines	通天酒业
China Railway Group Limited;China Railway	中国中铁
Mei Ah Entertainment Group Ltd.;Mei Ah Entertainment	美亚娱乐资讯
Beijing Enterprises Holdings Ltd.;Beijing Enterprises	北京控股
Glorious Sun Enterprises Ltd.;Glorious Sun Enterprises;Glorious Sun	旭日企业
Smartac Group China Holdings Limited;Smartac Group China	中国智能集团
Hing Lee (HK) Holdings Limited;Hing Lee	兴利(香港)控股
Power Financial Group Limited;Power Financial	权威金融
Oriental Watch Holdings Ltd.;Oriental Watch	东方表行集团
Innovative Pharmaceutical Biotech Limited;Innovative Pharmaceutical Biotech	领航医药生物科技
Cogobuy Group;Cogobuy	科通芯城
Wanjia Group Holdings Limited;Wanjia Group;Wanjia	万嘉集团
Peace Map Holding Limited;Peace Map	天下图控股
Starlite Holdings Ltd.;Starlite	星光集团
Hsin Chong Group Holdings Limited;Hsin Chong	新昌集团控股
Yau Lee Holdings Ltd.;Yau Lee	有利集团
Yip's Chemical Holdings Limited;Yip's Chemical	叶氏化工集团
SOHO China Ltd;SOHO China	SOHO中国
Lam Soon (Hong Kong) Ltd.;Lam Soon	南顺(香港)
China Shandong Hi-Speed Financial Group Limited;China Shandong Hi-Speed Financial	中国山东高速金融
South China Holdings Company Limited;South China	南华集团控股
Bank of Jinzhou Co., Ltd.;Bank of Jinzhou	锦州银行
Tse Sui Luen Jewellery (International) Ltd.;Tse Sui Luen Jewellery	谢瑞麟
Founder Holdings Limited;Founder Holdings	方正控股
Huayi Tencent Entertainment Company Limited;Huayi Tencent Entertainment	华谊腾讯娱乐
Fountain Set (Holdings) Ltd.;Fountain Set	福田实业
Vietnam Manufacturing and Export Processing (Holdings) Ltd;Vietnam Manufacturing and Export Processing	越南制造加工出口
Hong Kong Economic Times Holdings Ltd;Hong Kong Economic Times;Economic Times	经济日报集团
Minth Group Limited;Minth	敏实集团
One Media Group Limited;One Media	万华媒体
Cocoon Holdings Limited;Cocoon	中国天弓控股
Oriental Explorer Holdings Ltd.;Oriental Explorer	东方网库
Greater China Financial Holdings Limited;Greater China Financial	大中华金融
Pacific Century Premium Developments Ltd.;Pacific Century Premium Developments;Pacific Century Premium	盈大地产
North Mining Shares Company Limited;North Mining Shares	北方矿业
Boyaa Interactive International Limited;Boyaa Interactive	博雅互动
New Universe Environmental Group Limited;New Universe Environmental	新宇环保
IRICO Group New Energy Company Limited;IRICO Group New Energy	彩虹新能源
KuangChi Science Limited;KuangChi Science	光启科学
Dah Sing Financial Holdings Ltd.;Dah Sing Financial	大新金融
Hifood Group Holdings Co., Limited;Hifood Group Holdings;Hifood Group	海福德集团
Sincere Watch (Hong Kong) Ltd;Sincere Watch	SINCEREWATCH HK
CIMC-TianDa Holdings Company Limited;CIMC-TianDa	中集天达
Chigo Holding Limited;Chigo	志高控股
Hung Hing Printing Group Ltd.;Hung Hing Printing	鸿兴印刷集团
GCL New Energy Holdings Limited;GCL New Energy	协鑫新能源
Tianda Pharmaceuticals Limited;Tianda Pharmaceuticals	天大药业
New City Development Group Limited;New City Development	新城市建设发展
Tristate Holdings Ltd.;Tristate	联亚集团
Midland IC&I Limited;Midland IC&I	美联工商铺
Sihuan Pharmaceutical Holdings Group Ltd.;Sihuan Pharmaceutical	四环医药
Natural Dairy (NZ) Holdings Limited;Natural Dairy (NZ);Natural Dairy	天然乳品
Kenford Group Holdings Limited;Kenford	建福集团
Futong Technology Development Holdings Limited;Futong Technology Development;Futong Technology	富通科技
United Energy Group Limited;United Energy	联合能源集团
Greatview Aseptic Packaging Company Limited;Greatview Aseptic Packaging	纷美包装
Capxon Intermational Electronic Company Limited;Capxon Intermational Electronic	凯普松国际
CMMB Vision Holdings Limited;CMMB Vision	中播控股
New Silkroad Culturaltainment Limited;New Silkroad Culturaltainment	新丝路文旅
Hao Tian Development Group Limited;Hao Tian Development;Hao Tian	昊天发展集团
Zhong Fa Zhan Holdings Limited;Zhong Fa Zhan	中发展控股
China Dynamics (Holdings) Limited;China Dynamics	中国动力控股
CIL Holdings Ltd.;CIL Holdings	华建控股
HKR International Ltd.;HKR International	香港兴业国际
Sandmartin International Holdings Limited;Sandmartin	圣马丁国际
Bauhaus International (Holdings) Limited;Bauhaus International;Bauhaus	包浩斯国际
Forgame Holdings Limited;Forgame	云游控股
China Sinostar Group Company Limited;China Sinostar;Sinostar	中国华星
United Company RUSAL Plc;United Company RUSAL Plc;RUSAL Plc	俄铝
Success Universe Group Limited;Success Universe	实德环球
Lai Sun Development Co. Ltd.;Lai Sun Development;Lai Sun	丽新发展
Dongfeng Motor Group Co. Ltd.;Dongfeng Motor	东风集团股份
Emperor Culture Group Limited;Emperor Culture	英皇文化产业
GOME Retail Holdings Limited;GOME Retail	国美零售
Li & Fung Ltd.;Li & Fung	利丰
Paladin Ltd.;Paladin	PALADIN
Kasen International Holdings Limited;Kasen International;Kasen	卡森国际
CSI Properties Limited;CSI Properties	资本策略地产
PYI Corporation Limited;PYI	保华集团
Qingdao Holdings International Limited;Qingdao Holdings	青岛控股
Frontier Services Group Limited;Frontier Services	先丰服务集团
Lansen Pharmaceutical Holdings Limited;Lansen Pharmaceutical	朗生医药
Huan Yue Interactive Holdings Limited;Huan Yue Interactive	欢悦互娱
China Foods Limited;China Foods	中国食品
Dingyi Group Investment Limited;Dingyi Group Investment	鼎亿集团投资
Century Sunshine Group Holdings Limited;Century Sunshine	世纪阳光
CASH Financial Services Group Ltd.;CASH Financial Services	时富金融服务集团
Television Broadcasts Ltd.;Television Broadcasts	电视广播
China Grand Pharmaceutical and Healthcare Holding Limited;China Grand Pharmaceutical and Healthcare;Grand Pharmaceutical and Healthcare	远大医药
Continental Holdings Ltd.;Continental	恒和集团
TC Orient Lighting Holdings Limited;TC Orient Lighting	达进东方照明
COSCO SHIPPING International (Hong Kong) Co., Ltd.;COSCO SHIPPING International;COSCO SHIPPING	中远海运国际
Tungtex (Holdings) Co. Ltd.;Tungtex	同得仕(集团)
Applied Development Holdings Limited;Applied Development	实力建业
Xiabuxiabu Catering Management (China) Holdings Co., Ltd.;Xiabuxiabu Catering Management;Xiabuxiabu	呷哺呷哺
CWT International Limited;CWT International	CWT INT’L
ASM Pacific Technology Limited;ASM Pacific Technology;ASM Pacific	ASM PACIFIC
Great Wall Belt & Road Holdings Limited;Great Wall Belt & Road	长城一带一路
Guangshen Railway Company Limited;Guangshen Railway	广深铁路股份
Lisi Group (Holdings) Limited;Lisi Group;Lisi	利时集团控股
China Ruifeng Renewable Energy Holdings Limited;China Ruifeng Renewable Energy;Ruifeng Renewable Energy	瑞风新能源
Kingdom Holdings Limited;Kingdom Holdings	金达控股
SiS International Holdings Ltd.;SiS International	SIS INT'L
Goldin Financial Holdings Limited;Goldin Financial	高银金融
Samson Holding Limited;Samson	顺诚
Wong's Kong King International (Holdings) Ltd.;Wong's Kong King International	WKK INTL (HOLD)
Goldlion Holdings Ltd.;Goldlion	金利来集团
Gemdale Properties and Investment Corporation Limited;Gemdale Properties and Investment	金地商置
Tradelink Electronic Commerce Limited;Tradelink Electronic Commerce	贸易通
Ajisen (China) Holdings Limited;Ajisen	味千(中国)
Victory City International Holdings Ltd.;Victory City	冠华国际控股
Speedy Global Holdings Limited;Speedy Global	迅捷环球控股
TFG International Group Limited;TFG International	富元国际集团
Pacific Online Ltd;Pacific Online	太平洋网络
Daido Group Ltd.;Daido Group	大同集团
Fufeng Group Ltd;Fufeng Group	阜丰集团
Digital Domain Holdings Limited;Digital Domain	数字王国
Shenzhen Expressway Company Limited;Shenzhen Expressway	深圳高速公路股份
KK Culture Holdings Limited;KK Culture	KK文化
Yue Yuen Industrial (Holdings) Ltd.;Yue Yuen Industrial;Yue Yuen	裕元集团
China Communications Services Corporation Limited;China Communications Services	中国通信服务
Nanjing Panda Electronics Company Limited;Nanjing Panda Electronics;Panda Electronics	南京熊猫电子股份
Hans Energy Company Limited;Hans Energy	汉思能源
REXLot Holdings Limited;REXLot	御泰中彩控股
Pan Asia Environmental Protection Group Limited;Pan Asia Environmental Protection	泛亚环保
China Tian Yuan Healthcare Group Limited;China Tian Yuan Healthcare	天元医疗
L.K. Technology Holdings Limited;L.K. Technology	力劲科技
DeTai New Energy Group Limited;DeTai New Energy	德泰新能源集团
Chu Kong Shipping Enterprises (Group) Company Limited;Chu Kong Shipping Enterprises	珠江船务
Shanghai Industrial Urban Development Group Limited;Shanghai Industrial Urban Development;Shanghai Industrial Urban	上实城市开发
Zhengzhou Coal Mining Machinery Group Co., Ltd;Zhengzhou Coal Mining Machinery	郑煤机
Art Group Holdings Limited;Art Group	锦艺集团控股
Hanergy Thin Film Power Group Limited;Hanergy Thin Film Power	汉能薄膜发电
Daisho Microline Holdings Limited;Daisho Microline	大昌微线集团
Shandong Molong Petroleum Machinery Co.,Ltd.;Shandong Molong Petroleum Machinery;Shandong Molong Petroleum	山东墨龙
China Automation Group Limited;China Automation	中国自动化
China traditional chinese medicine holdings co. Limited;China traditional chinese medicine holdings;China traditional chinese medicine	中国中药
eSun Holdings Ltd.;eSun Holdings	丰德丽控股
Future World Financial Holdings Limited;Future World Financial	未来世界金融
Tao Heung Holdings Ltd;Tao Heung	稻香控股
Pa Shun International Holdings Limited;Pa Shun	百信国际
Regent Pacific Group Ltd.;Regent Pacific	励晶太平洋
Zhejiang Expressway Co., Ltd.;Zhejiang Expressway	浙江沪杭甬
South Shore Holdings Limited;South Shore	南岸集团
Rosan Resources Holdings Limited;Rosan Resources	融信资源
Beijing Jingneng Clean Energy Co., Limited;Beijing Jingneng Clean Energy;Jingneng Clean Energy	京能清洁能源
Sun.King Power Electronics Group Limited;Sun.King Power Electronics	赛晶电力电子
China Oriental Group Co. Ltd.;China Oriental	中国东方集团
Landing International Development Limited;Landing International Development;Landing International	蓝鼎国际
Great Wall Pan Asia Holdings Limited;Great Wall Pan Asia	长城环亚控股
Imagi International Holdings Limited;Imagi International	意马国际
China Conch Venture Holdings Limited;China Conch Venture	海螺创业
Hua Han Health Industry Holdings Limited;Hua Han Health Industry;Hua Han Health	华瀚健康
Beijing North Star Company Limited;Beijing North Star	北京北辰实业股份
Luk Fook Holdings (International) Ltd.;Luk Fook Holdings;Luk Fook	六福集团
China High Precision Automation Group Limited;China High Precision Automation	中国高精密
Bossini International Holdings Ltd.;Bossini	BOSSINI INT'L
DreamEast Group Limited;DreamEast	梦东方
AV Concept Holdings Ltd.;AV Concept	AV CONCEPT HOLD
Inspur International Limited;Inspur	浪潮国际
Sinotrans Limited;Sinotrans	中国外运
E. Bon Holdings Ltd;E. Bon	怡邦行控股
China Infrastructure Investment Limited;China Infrastructure Investment	中国基建投资
Rare Earth Magnesium Technology Group Holdings Limited;Rare Earth Magnesium Technology	稀镁科技
Jiahua Stores Holdings Limited;Jiahua Stores	佳华百货控股
China Oil and Gas Group Limited;China Oil and Gas	中油燃气
Shenzhen Investment Limited;Shenzhen Investment	深圳控股
China Financial Services Holdings Limited;China Financial Services	中国金融投资管理
China agri-industries holdings Limited;China agri-industries	中国粮油控股
Fullshare Holdings Limited;Fullshare	丰盛控股
High Fashion International Limited;High Fashion	达利国际
Tiande Chemical Holdings Limited;Tiande Chemical	天德化工
Wai Kee Holdings Ltd.;Wai Kee	WAI KEE HOLD
China Nuclear Energy Technology Corporation Limited;China Nuclear Energy Technology	中国核能科技
China Investment Fund International Holdings Limited;China Investment Fund	中国投资基金公司
Yugang International Ltd.;Yugang	YUGANG INT'L
Eminence Enterprise Limited;Eminence Enterprise	高山企业
Paliburg Holdings Ltd.;Paliburg	百利保控股
Peking University Resources (Holdings) Company Limited;Peking University Resources	北大资源
South China Financial Holdings Limited;South China Financial	南华金融
DTXS Silk Road Investment Holdings Company Limited;DTXS Silk Road Investment;DTXS Silk Road	大唐西市
Taung Gold International Limited;Taung Gold	坛金矿业
Enerchina Holdings Ltd.;Enerchina	威华达控股
SinoMedia Holding Limited;SinoMedia	中视金桥
Public Financial Holdings Limited;Public Financial	大众金融控股
Fullsun International Holdings Group Co., Limited;Fullsun International Holdings Group;Fullsun International	福晟国际
Gome Finance Technology Co., Ltd.;Gome Finance Technology	国美金融科技
Yue Da Mining Holdings Limited;Yue Da Mining	悦达矿业
Amco United Holding Limited;Amco United	隽泰控股
Sany Heavy Equipment International Holdings Company Limited;Sany Heavy Equipment International;Sany Heavy Equipment	三一国际
Pearl Oriental Oil Limited;Pearl Oriental Oil	东方明珠石油
China All Access (Holdings) Limited;China All Access	中国全通
Playmates Holdings Ltd.;Playmates	彩星集团
Kerry Logistics Network Limited;Kerry Logistics Network;Kerry Logistics	嘉里物流
LEE KEE Hoidings Limited;LEE KEE Hoidings;LEE KEE	利记
Kin Yat Holdings Ltd.;Kin Yat	建溢集团
Shougang Fushan Resources Group Limited;Shougang Fushan Resources	首钢资源
Infinity Development Holdings Company Limited;Infinity Development	星谦发展
CHTC Fong's International Company Limited;CHTC Fong's International	中国恒天立信国际
Carry Wealth Holdings Ltd.;Carry Wealth	恒富控股
Ares Asia Limited;Ares Asia	安域亚洲
China Environmental Technology Holdings Limited;China Environmental Technology	中国环保科技
Joyce Boutique Holdings Limited;Joyce Boutique	JOYCE BOUTIQUE
China Wah Yan Healthcare Limited;China Wah Yan Healthcare;Wah Yan Healthcare	中国华仁医疗
IDG Energy Investment Limited;IDG Energy Investment	IDG能源投资
China Ocean Industry Group Limited;China Ocean Industry	中海重工
Bonjour Holdings Ltd.;Bonjour Holdings	卓悦控股
Hongkong Chinese Ltd.;Hongkong Chinese	香港华人有限公司
Fosun International Limited;Fosun International	复星国际
G-Vision International (Holdings) Ltd.;G-Vision International	环科国际
China High Speed Transmission Equipment Group Co., Ltd.;China High Speed Transmission Equipment	中国高速传动
NWS Holdings Ltd.;NWS	新创建集团
Wai Chun Mining Industry Group Company Limited;Wai Chun Mining Industry;Wai Chun Mining	伟俊矿业集团
China Daye Non-Ferrous Metals Mining Limited;China Daye Non-Ferrous Metals Mining	中国大冶有色金属
Asia Financial Holdings Ltd.;Asia Financial	亚洲金融
King Stone Energy Group Limited;King Stone Energy	金山能源
Haitong International Securities Group Limited;Haitong International Securities	海通国际
SHK Hong Kong Industries Limited;SHK Hong Kong Industries	新工投资
Doyen International Holdings Ltd.;Doyen International	东银国际控股
Techtronic Industries Co. Ltd.;Techtronic Industries	创科实业
China Eastern Airlines Corporation Limited;China Eastern Airlines;Eastern Airlines	中国东方航空股份
Zhong An Real Estate Ltd;Zhong An Real Estate	众安房产
China Health Group Limited;China Health	中国卫生集团
China Tangshang Holdings Limited;China Tangshang	中国唐商
K & P International Holdings Ltd.;K&P	坚宝国际
Pegasus International Holdings Ltd.;Pegasus	创信国际
Golden Resources Development International Ltd.;Golden Resources Development;Golden Resources	金源米业
Genting Hong Kong Limited;Genting Hong Kong	云顶香港
Asia Tele-Net and Technology Corporation Ltd.;Asia Tele-Net and Technology	亚洲联网科技
Nan Hai Corporation Limited;Nan Hai	南海控股
Chinese People Holdings Company Limited;Chinese People	中民控股
Chaoda Modern Agriculture (Holdings) Ltd.;Chaoda Modern Agriculture;Chaoda Modern	超大现代
Kerry Properties Limited;Kerry Properties	嘉里建设
Allan International Holdings Ltd.;Allan International	亚伦国际
Media Chinese International Limited;Media Chinese	世界华文媒体
Panda Green Energy Group Limited;Panda Green Energy	熊猫绿能
Hong Kong International Construction Investment Management Group Co., Limited;Hong Kong International Construction Investment Management;Hong Kong International Construction	香港国际建投
China Overseas Land & Investment Ltd.;China Overseas Land & Investment	中国海外发展
EPI (Holdings) Limited;EPI Holdings	长盈集团(控股)
Uni-Bio Science Group Limited;Uni-Bio Science	联康生物科技集团
China Shanshui Cement Group Limited;China Shanshui Cement	山水水泥
Shenzhou Space Park Group Limited;Shenzhou Space Park	中国家居
Tan Chong International Ltd.;Tan Chong	陈唱国际
Beijing Capital International Airport Company Limited;Beijing Capital International Airport	北京首都机场股份
Dongwu Cement International Limited;Dongwu Cement	东吴水泥
Travelsky Technology Limited;Travelsky Technology	中国民航信息网络
Shougang Concord International Enterprises Co. Ltd.;Shougang Concord International Enterprises;Shougang Concord International	SHOUGANG INT'L
Tongda Group Holdings Ltd.;Tongda Group	通达集团
CAR Inc.;CAR	神州租车
Tencent Holdings Ltd;Tencent	腾讯控股
CNT Group Ltd.;CNT Group	CNT GROUP
Sino Oil and Gas Holdings Limited;Sino Oil and Gas	中国油气控股
Future Bright Holdings Limited;Future Bright	FUTURE BRIGHT
Huscoke Resources Holdings Limited;Huscoke Resources	和嘉资源
Ding He Mining Holdings Limited;Ding He Mining	鼎和矿业
Beautiful China Holdings Company Limited;Beautiful China	美丽中国控股
Asia Television Holdings Limited;Asia Television	亚洲电视控股
Evergrande Health Industry Group Limited;Evergrande Health Industry;Evergrande Health	恒大健康
Giordano International Ltd.;Giordano	佐丹奴国际
BOE Varitronix Limited;BOE Varitronix	京东方精电
Asia Allied Infrastructure Holdings Limited;Asia Allied Infrastructure	亚洲联合基建控股
Comtec Solar Systems Co.,Ltd;Comtec Solar Systems	卡姆丹克太阳能
World Houseware (Holdings) Ltd.;World Houseware	世界(集团)
China Oceanwide Holdings Limited;China Oceanwide	中泛控股
Singamas Container Holdings Ltd.;Singamas Container	胜狮货柜
Emperor Capital Group Limited;Emperor Capital	英皇证券
Tai United Holdings Limited;Tai United	太和控股
Shandong Xinhua Pharmaceutical Company Limited;Shandong Xinhua Pharmaceutical;Xinhua Pharmaceutical	山东新华制药股份
Auto Italia Holdings Limited;Auto Italia	意达利控股
China Financial International Investments Limited;China Financial International Investments	中国金融国际
Ump Healthcare Holdings Limited;Ump Healthcare	联合医务
Sustainable Forest Holdings Limited;Sustainable Forest	永保林业
Ruixin International Holdings Limited;Ruixin	瑞鑫国际集团
Perennial International Limited;Perennial	恒都集团
China Minsheng DIT Group Limited;China Minsheng DIT;Minsheng DIT	中民筑友智造科技
Crown International Corporation Limited;Crown International	皇冠环球集团
China Telecom Corporation Limited;China Telecom	中国电信
FDG Electric Vehicles Limited;FDG Electric Vehicles	五龙电动车
Shougang Concord Grand (Group) Ltd.;Shougang Concord Grand	SHOUGANG GRAND
Samson Paper Holdings Ltd.;Samson Paper	森信纸业集团
Truly International Holdings Ltd.;Truly International	信利国际
Hopefluent Group Holdings Ltd;Hopefluent	合富辉煌
China Power Clean Energy Development Company Limited;China Power Clean Energy Development	中国电力清洁能源
China Properties Investment Holdings Limited;China Properties Investment	中国置业投资
Hopewell Highway Infrastructure Ltd.;Hopewell Highway Infrastructure	合和公路基建
Le Saunda Holdings Limited;Le Saunda	莱尔斯丹
Asia Cement (China) Holdings Corporation;Asia Cement	亚洲水泥(中国)
China National Culture Group Limited;China National Culture	中国国家文化产业
Lee & Man Chemical Company Limited;Lee & Man Chemical	理文化工
Shenyang Public Utility Holdings Co. Limited;Shenyang Public Utility Holdings;Shenyang Public Utility	沈阳公用发展股份
China Singyes Solar Technologies Holdings Limited;China Singyes Solar Technologies;Singyes Solar Technologies	兴业太阳能
Skyworth Digital Holdings Ltd.;Skyworth Digital	创维数码
Pico Far East Holdings Ltd.;Pico Far East	PICO FAR EAST
Air China Limited;Air China	中国国航
Hopson Development Holdings Ltd.;Hopson Development	合生创展集团
Shanghai Zendai Property Limited;Shanghai Zendai Property;Zendai Property	上海证大
Summi (Group) Holdings Limited;Summi	森美控股
Solargiga Energy Holdings Ltd.;Solargiga Energy	阳光能源
Macrolink Capital Holdings Limited;Macrolink Capital	JUNEFIELD GROUP
CEC International Holdings Ltd.;CEC International	CEC INT'L HOLD
Talent Property Group Limited;Talent Property	新天地产集团
China Unicom (Hong Kong) Ltd.;China Unicom	中国联通
ZTE Corporation;ZTE	中兴通讯
Eternity Investment Limited;Eternity Investment	永恒策略
Perfectech International Holdings Ltd.;Perfectech	PERFECTECH INTL
Sino Prosper (Group) Holdings Limited;Sino Prosper	中盈集团控股
Asia Pacific Silk Road Investment Company Limited;Asia Pacific Silk Road Investment	亚太丝路投资
UBA Investments Ltd.;UBA Investments	开明投资
China Rare Earth Holdings Ltd;China Rare Earth	中国稀土
Shanghai International Shanghai Growth Investment Ltd.;Shanghai International Shanghai Growth Investment	SHANGHAI GROWTH
Automated Systems Holdings Ltd.;Automated Systems	自动系统
China Literature Limited;China Literature	阅文集团
CK Life Sciences Int'l., (Holdings) Inc.;CK Life Sciences	长江生命科技
Imperium Group Global Holdings Limited;Imperium Group Global	帝国集团环球控股
NetDragon Websoft Holdings Limited;NetDragon Websoft	网龙
Ling Yui Holdings Limited;Ling Yui	凌锐控股
Global Brands Group Holding Limited;Global Brands	利标品牌
China Tower Corporation Limited;China Tower	中国铁塔
Primeview Holdings Limited;Primeview	领视控股
Come Sure Group (Holdings) Limited;Come Sure	锦胜集团(控股)
7Road Holdings Limited;7Road	第七大道
China Electronics Optics Valley Union Holding Company Limited;China Electronics Optics Valley Union Holding;China Electronics Optics Valley	中电光谷
IGG Inc;IGG	IGG
A8 New Media Group Limited;A8 New Media	A8新媒体
Golden Meditech Holdings Limited;Golden Meditech	金卫医疗
China e-Wallet Payment Group Limited;China e-Wallet Payment	中国钱包
Prosperity International Holdings (H.K.) Ltd.;Prosperity International Holdings	昌兴国际
Pinestone Capital Limited;Pinestone Capital	鼎石资本
Value Partners Group Limited;Value Partners	惠理集团
SIIC Environment Holdings Ltd.;SIIC Environment	上海实业环境
Global Bio-chem Technology Group Co. Ltd;Global Bio-chem Technology	大成生化科技
China Internet Investment Finance Holdings Limited;China Internet Investment Finance	中国互联网投资
Xinhua Winshare Publishing and Media Co., Ltd.;Xinhua Winshare Publishing and Media	新华文轩
Southwest Securities International Securities Limited;Southwest Securities International Securities	西证国际证券
Shimao Property Holdings Ltd.;Shimao Property	世茂房地产
Beijing Jingkelong Company Limited;Beijing Jingkelong	北京京客隆
China Silver Group Limited;China Silver	中国白银集团
Huadian Fuxin Energy Corporation Limited;Huadian Fuxin Energy;Huadian Fuxin	华电福新
China Jinmao Holdings Group Limited;China Jinmao	中国金茂
Hi Sun Technology (China) Limited;Hi Sun Technology	高阳科技
Tianneng Power International Ltd;Tianneng Power	天能动力
Value Convergence Holdings Ltd.;Value Convergence	汇盈控股
Ka Shui International Holdings Limited;Ka Shui	嘉瑞国际
New World Department Store China Ltd;New World Department Store China;New World Department Store	新世界百货中国
Tiangong International Company Limited;Tiangong International	天工国际
Ko Yo Chemical (Group) Limited;Ko Yo Chemical	玖源集团
Dynasty Fine Wines Group Ltd;Dynasty Fine Wines	王朝酒业
Shenguan Holdings (Group) Ltd.;Shenguan Holdings	神冠控股
Far East Global Group Limited;Far East Global	远东环球
Convenience Retail Asia Ltd;Convenience Retail Asia	利亚零售
Central China Real Estate Ltd;Central China Real Estate	建业地产
Alltronics Holdings Ltd;Alltronics	华讯
China Kangda Food Company Limited;China Kangda Food;Kangda Food	康大食品
Asia Coal Limited;Asia Coal	亚洲煤业
China Resources Power Holdings Co. Ltd.;China Resources Power	华润电力
Carpenter Tan Holdings Limited;Carpenter Tan	谭木匠
EVA Precision Industrial Holdings Ltd;EVA Precision Industrial	亿和控股
China Education Group Holdings Limited;China Education	中教控股
Xinjiang Tianye Water Saving Irrigation System Company Limited;Xinjiang Tianye Water Saving Irrigation System;Tianye Water Saving	天业节水
Asia Cassava Resources Holdings Ltd.;Asia Cassava Resources;Cassava Resources	木薯资源
Leoch International Technology Limited;Leoch International Technology	理士国际
Greatime International Holdings Limited;Greatime	广泰国际控股
Glorious Property Holdings Ltd;Glorious Property	恒盛地产
Mingfa Group (International) Company Limited;Mingfa Group	明发集团
Maoye International Holdings Limited;Maoye	茂业国际
Tou Rong Chang Fu Group Limited;Tou Rong Chang Fu	投融长富
Sheng Yuan Holdings Limited;Sheng Yuan	盛源控股
Strong Petrochemical Holdings Limited;Strong Petrochemical	海峡石油化工
MicroPort Scientific Corporation;MicroPort Scientific	微创医疗
Willas-Array Electronics (Holdings) Limited;Willas-Array Electronics	威雅利
China Water Affairs Group Limited;China Water Affairs	中国水务
VSTECS Holdings Limited;VSTECS	伟仕佳杰
Petrochina Company Limited;Petrochina	中国石油股份
Extrawell Pharmaceutical Holdings Ltd.;Extrawell Pharmaceutical	精优药业
Zhongchang International Holdings Group Limited;Zhongchang	中昌国际控股
WE Solutions Limited;WE Solutions	力世纪
Digital China Holdings Ltd.;Digital China	神州控股
Vision Values Holdings Limited;Vision Values	远见控股
Branding China Group Limited;Branding China	品牌中国
Wing Lee Property Investments Limited;Wing Lee Property Investments	永利地产发展
Jiande International Holdings Limited;Jiande	建德国际控股
China Qinfa Group Ltd.;China Qinfa	中国秦发
China Medical System Holdings Limited;China Medical System	康哲药业
XinYi Glass Holdings Limited;XinYi Glass	信义玻璃
Playmates Toys Limited;Playmates Toys	彩星玩具
China Dredging Environment Protection Holdings Limited;China Dredging Environment Protection;Dredging Environment Protection	中国疏浚环保
TUS International Limited;TUS International	启迪国际
China Taifeng Beddings Holdings Limited;China Taifeng Beddings;Taifeng Beddings	中国泰丰床品
Guangzhou Baiyunshan Pharmaceutical Holdings Company Limited;Guangzhou Baiyunshan Pharmaceutical;Baiyunshan Pharmaceutical	白云山
China Finance Investment Holdings Limited;China Finance Investment	中国金控
Kaisa Health Group Holdings Limited;Kaisa Health	佳兆业健康
O-Net Technologies (Group) Limited;O-Net Technologies	昂纳科技集团
Soundwill Holdings Ltd.;Soundwill	金朝阳集团
SJM Holdings Limited;SJM Holdings	澳博控股
Zhongsheng Group Holdings Ltd;Zhongsheng	中升控股
Tianjin Development Holdings Ltd.;Tianjin Development	天津发展
CNOOC Limited;CNOOC	中国海洋石油
CIFI Holdings (Group) Co. Ltd.;CIFI Holdings	旭辉控股集团
Rentian Technology Holdings Limited;Rentian Technology	仁天科技控股
Silver Base Group Holdings Ltd.;Silver Base	银基集团
Emperor Watch & Jewellery Limited;Emperor Watch & Jewellery	英皇钟表珠宝
Bison Finance Group Limited;Bison Finance	贝森金融
Datronix Holdings Ltd.;Datronix	连达科技控股
Trinity Limited;Trinity	利邦
China Vanadium Titano-Magnetite Mining Co. Ltd.;China Vanadium Titano-Magnetite Mining	中国铁钛
Man Yue Technology Holdings Limited;Man Yue Technology	万裕科技
Dongjiang Environmental Company Limited;Dongjiang Environmental	东江环保
Hanison Construction Holdings Ltd.;Hanison Construction	兴胜创建
Wai Yuen Tong Medicine Holdings Ltd.;Wai Yuen Tong Medicine;Wai Yuen Tong	位元堂
Multifield International Holdings Ltd.;Multifield	万事昌国际
Asia Resources Holdings Ltd.;Asia Resources	亚洲资源
Aeon Credit Service (Asia) Company Limited;Aeon Credit Service	AEON CREDIT
Eagle Ride Investment Holdings Limited;Eagle Ride Investment	鹰力投资
Huaneng Power International,Inc.;Huaneng Power International	华能国际电力股份
TPV Technology Limited;TPV Technology	冠捷科技
China Green (Holdings) Limited;China Green	中绿
Global Mastermind Capital Limited;Global Mastermind Capital	环球大通投资
CPMC Holdings Limited;CPMC Holdings	中粮包装
Elegance Optical International Holdings Limited;Elegance Optical	高雅光学
Zhuhai Holdings Investment Group Limited;Zhuhai Holdings Investment	珠海控股投资
Zhongda International Holdings Ltd.;Zhongda	中大国际
China Sandi Holdings Limited;China Sandi	中国三迪
Qianhai Health Holdings Limited;Qianhai Health	前海健康
Suga International Holdings Ltd.;Suga	信佳国际
Unity Investments Holdings Limited;Unity Investments	合一投资
Anhui Conch Cement Company Limited;Anhui Conch Cement;Conch Cement	海螺水泥
Daohe Global Group Limited;Daohe Global	道和环球
China Longyuan Power Group Corporation Limited;China Longyuan Power Group;Longyuan Power	龙源电力
State Energy Group International Assets Holdings Limited;State Energy Group International Assets	国能国际资产
Modern Beauty Salon Holdings Limited;Modern Beauty Salon	现代美容
Hisense Kelon Electrical Holdings Co.,Ltd;Hisense Kelon Electrical Holdings;Hisense Kelon Electrical	海信科龙
Anxian Yuan China Holdings Limited;Anxian Yuan China	安贤园中国
Integrated Waste Solutions Group Holdings Limited;Integrated Waste Solutions	综合环保集团
Beijing Properties (Holdings) Limited;Beijing Properties	北京建设
Besunyen Holdings Company Limited;Besunyen	碧生源
Fujikon Industrial Holdings Ltd.;Fujikon Industrial;Fujikon	富士高实业
Life Healthcare Group Limited;Life Healthcare	莲和医疗
IPE Group Limited;IPE Group	国际精密
China LNG Group Limited;China LNG	中国天然气
Shunten International (Holdings) Limited;Shunten International	顺腾国际控股
Brightoil Petroleum (Holdings) Limited;Brightoil Petroleum	光汇石油
Sinopec Kantons Holdings Ltd.;Sinopec Kantons	中石化冠德
Dragon Crown Group Holdings Ltd;Dragon Crown	龙翔集团
Eagle Legend Asia Limited;Eagle Legend Asia	鹏程亚洲
Man Sang International Ltd.;Man Sang	民生国际
China Construction Bank Corporation;China Construction Bank;Construction Bank	建设银行
China Animal Healthcare Ltd.;China Animal Healthcare	中国动物保健品
China Mobile Limited;China Mobile	中国移动
eForce Holdings Ltd.;eForce	意科控股
Manulife Financial Corporation;Manulife Financial	宏利金融-S
MOBI Development Co., Ltd.;MOBI Development	摩比发展
Z-Obee Holdings Limited;Z-Obee	融达控股
Lee's Pharmaceutical Holdings Ltd.;Lee's Pharmaceutical	李氏大药厂
Chaowei Power Holdings Limited;Chaowei Power	超威动力
China Tonghai International Financial Limited;China Tonghai International Financial	中国通海金融
Shaw Brothers Holdings Limited;Shaw Brothers	邵氏兄弟控股
Changzhou Changmao Biology Chemical Engineering Stock Co., Ltd.;Changzhou Changmao Biology Chemical Engineering Stock;Changmao Biology Chemical Engineering	常茂生物
China Suntien Green Energy Company Limited;China Suntien Green Energy;Suntien Green Energy	新天绿色能源
Huaneng Renewables Corporation Limited;Huaneng Renewables	华能新能源
Amax International Holdings Limited;Amax	奥玛仕国际
Longfor Group Holdings Limited;Longfor	龙湖集团
China Taiping Insurance Holdings Company Limited;China Taiping Insurance;Taiping Insurance	中国太平
Sound Global Ltd.;Sound Global	桑德国际
Xinyi Solar Holdings Limited;Xinyi Solar	信义光能
Hua Lien International (Holding) Co. Ltd.;Hua Lien International	华联国际
Sparkle Roll Group Limited;Sparkle Roll	耀莱集团
L'occitane International S.A.;L'occitane International S.A.	L'OCCITANE
China Shun Ke Long Holdings Limited;China Shun Ke Long;Shun Ke Long	中国顺客隆
Mongolian Mining Corporation;Mongolian Mining	MONGOL MINING
Chiho Environmental Group Limited;Chiho Environmental	齐合环保
China Merchants Land Limited;China Merchants Land	招商局置地
Green Energy Group Limited;Green Energy	绿色能源科技集团
Lianhua Supermarket Holdings Co., Limited;Lianhua Supermarket Holdings;Lianhua Supermarket	联华超市
Semiconductor Manufacturing International Corporation;Semiconductor Manufacturing International	中芯国际
HJ Capital (International) Holdings Company Limited;HJ Capital	华金国际资本
SOCAM Development Limited;SOCAM Development;SOCAM	瑞安建业
AEON Stores (Hong Kong) Co., Ltd.;AEON Stores	永旺
CST Group Limited;CST Group	中誉集团
China Environmental Energy Investment Limited;China Environmental Energy Investment	中国环保能源
China Renewable Energy Investment Limited;China Renewable Energy Investment	中国再生能源投资
Silk Road Logistics Holdings Limited;Silk Road Logistics	丝路物流控股
Ground International Development Limited;Ground International Development	广泽国际发展
Theme International Holdings Ltd.;Theme International	荣晖国际
Datang International Power Generation Co.,Ltd.;Datang International Power Generation	大唐发电
Lenovo Group Limited;Lenovo	联想集团
Huarong International Financial Holdings Limited;Huarong International Financial	华融金控
Win Win Way Construction Holdings Ltd.;Win Win Way Construction	恒诚建筑
Anhui Expressway Company Limited;Anhui Expressway	安徽皖通高速公路
Carnival Group International Holdings Limited;Carnival	嘉年华国际
Chinlink International Holdings Limited;Chinlink	普汇中金国际
China CITIC Bank Corporation Limited;China CITIC Bank;CITIC Bank	中信银行
I.T Limited;I.T	I.T
Beijing Media Corporation Limited;Beijing Media	北青传媒
Hong Kong Shanghai Alliance Holdings Limited;Hong Kong Shanghai Alliance	沪港联合
V.S. International Group Ltd.;V.S. International	威铖国际
Huanxi Media Group Limited;Huanxi Media	欢喜传媒
China Smarter Energy Group Holdings Limited;China Smarter Energy	中国智慧能源
Matrix Holdings Ltd.;Matrix	MATRIX HOLDINGS
Changshouhua Food Company Limited;Changshouhua Food	长寿花食品
Longhui International Holdings Limited;Longhui	龙辉国际控股
Brilliant Circle Holdings International Limited;Brilliant Circle	贵联控股
International Entertainment Corporation;International Entertainment	国际娱乐
PacRay International Holdings Limited;PacRay	太睿国际控股
China NT Pharma Group Company Limited;China NT Pharma	泰凌医药
Wai Chun Group Holdings Limited;Wai Chun	伟俊集团控股
Convoy Global Holdings Limited;Convoy Global	康宏环球
Cybernaut International Holdings Company Limited;Cybernaut International	赛伯乐国际控股
Midas Holdings Limited;Midas Holdings	麦达斯控股-S
Feiyu Technology International Company Ltd.;Feiyu Technology International	飞鱼科技
Sitoy Group Holdings Limited;Sitoy Group	时代集团控股
Universal Technologies Holdings Ltd.;Universal Technologies	环球实业科技
China Jicheng Holdings Limited;China Jicheng	中国集成控股
C.banner International Holdings Limited;C.banner	千百度
IRC Limited;IRC	铁货
Future Land Development Holdings Limited;Future Land Development	新城发展控股
Kingston Financial Group Limited;Kingston Financial	金利丰金融
Sinopec Oilfield Service Corporation;Sinopec Oilfield Service	中石化油服
BBI Life Sciences Corporation;BBI Life Sciences	BBI生命科学
Vanke Property (Overseas) Limited;Vanke Property	万科置业海外
Maxnerva Technology Services Limited;Maxnerva Technology Services	云智汇科技
CK Infrastructure Holdings Limited;CK Infrastructure	长江基建集团
Fortunet e-Commerce Group Limited;Fortunet e-Commerce	鑫网易商
Lamtex Holdings Limited;Lamtex	林达控股
Coslight Technology International Group Ltd.;Coslight Technology	光宇国际集团科技
Hengan International Group Company Limited;Hengan International	恒安国际
APT Satellite Holdings Ltd.;APT Satellite	亚太卫星
Universe International Financial Holdings Limited;Universe International Financial	寰宇国际金融
Ngai Hing Hong Co. Ltd.;Ngai Hing Hong	毅兴行
Yorkshine Holdings Limited;Yorkshine	煜新控股
Celestial Asia Securities Holdings Limited;Celestial Asia Securities	时富投资
Karrie International Holdings Ltd.;Karrie	嘉利国际
G-Resources Group Limited;G-Resources	国际资源
Yuexiu Transport Infrastructure Limited;Yuexiu Transport Infrastructure	越秀交通基建
Chongqing Iron & Steel Company Limited;Chongqing Iron & Steel	重庆钢铁股份
China Southern Airlines Company Limited;China Southern Airlines	中国南方航空股份
Zhejiang Shibao Company Limited;Zhejiang Shibao	浙江世宝
Guangdong Tannery Ltd.;Guangdong Tannery	粤海制革
Kantone Holdings Ltd.;Kantone	看通集团
Alibaba Pictures Group Limited;Alibaba Pictures	阿里影业
Essex Bio-Technology Limited;Essex Bio-Technology	亿胜生物科技
China Development Bank International Investment Limited;China Development Bank International Investment	国开国际投资
SunCorp Technologies Ltd.;SunCorp Technologies	新确科技
Zhong Hua International Holdings Ltd.;Zhong Hua	中华国际
Tianjin Capital Environmental Protection Group Company Limited;Tianjin Capital Environmental Protection	天津创业环保股份
Shandong Weigao Group Medical Polymer Co. Limited;Shandong Weigao Group Medical Polymer	威高股份
China Yurun Food Group Limited;China Yurun Food	雨润食品
China Agroforestry Low-Carbon Holdings Limited;China Agroforestry Low-Carbon	中国农林低碳
TCL Electronics Holdings Limited;TCL Electronics	TCL电子
Huadian Power International Corporation Limited;Huadian Power International	华电国际电力股份
Dongfang Electric Corporation Limited;Dongfang Electric	东方电气
China Agrotech Holdings Ltd;China Agrotech	浩伦农科
Capinfo Company Limited;Capinfo	首都信息
Imperial Pacific International Holdings Limited;Imperial Pacific	博华太平洋
PINE Technology Holdings Limited;PINE Technology	松景科技
Shengli Oil & Gas Pipe Holdings Limited;Shengli Oil & Gas Pipe	胜利管道
Hong Kong Education (Int'l) Investments Limited;Hong Kong Education (Int'l) Investments	香港教育国际
Towngas China Company Limited;Towngas China	港华燃气
Hengxin Technology Ltd.;Hengxin Technology	亨鑫科技
Goodbaby International Holdings Ltd;Goodbaby	好孩子国际
InvesTech Holdings Limited;InvesTech	威讯控股
China Shenhua Energy Company Limited;China Shenhua Energy	中国神华
Leyou Technologies Holdings Limited;Leyou Technologies	乐游科技控股
Da Ming International Holdings limited;Da Ming	大明国际
CITIC Dameng Holdings Limited;CITIC Dameng	中信大锰
CSPC Pharmaceutical Group Limited;CSPC Pharmaceutical	石药集团
China Public Procurement Limited;China Public Procurement	中国公共采购
Sino Energy International Holdings Group Limited;Sino Energy	中能国际控股
i-CABLE Communications Limited;i-CABLE Communications	有线宽频
Road King Infrastructure Ltd.;Road King Infrastructure	路劲
Sinopharm Group Co., Ltd.;Sinopharm	国药控股
Mainland Headwear Holdings Ltd.;Mainland Headwear	飞达控股
China Huarong Energy Company Limited;China Huarong Energy	华荣能源
Enviro Energy International Holdings Limited;Enviro Energy	环能国际
Shanghai Dasheng Agriculture Finance Technology Co., Ltd.;Shanghai Dasheng Agriculture Finance Technology	大生农业金融
APAC Resources Limited;APAC Resources	亚太资源
Sing Tao News Corporation Limited;Sing Tao News	星岛
Sino Haijing Holdings Limited;Sino Haijing	中国海景
Modern Land (China) Co., Limited;Modern Land	当代置业
Luoyang Glass Company Limited;Luoyang Glass	洛阳玻璃股份
China Resources Land Limited;China Resources Land	华润置地
Kingworld Medicines Group Limited;Kingworld Medicines	金活医药集团
Chong Hing Bank Limited;Chong Hing Bank	创兴银行
Health and Happiness (H&H) International Holdings Limited;Health and Happiness (H&H)	H&H国际控股
CK Asset Holdings Limited;CK Asset	长实集团
Brilliance China Automotive Holdings Ltd.;Brilliance China Automotive	BRILLIANCE CHI
Tibet Water Resources Ltd.;Tibet Water Resources	西藏水资源
Mayer Holdings Ltd.;Mayer Holdings	MAYER HOLDINGS
China Modern Dairy Holdings Ltd.;China Modern Dairy	现代牧业
Golik Holdings Ltd.;Golik Holdings	高力集团
Arts Optical International Holdings Ltd.;Arts Optical	雅视光学
Baofeng Modern International Holdings Company Limited;Baofeng Modern International	宝峰时尚
Qingling Motors Co. Limited;Qingling Motors	庆铃汽车股份
China-Hongkong Photo Products Holdings Ltd.;China-Hongkong Photo Products	中港照相
Coastal Greenland Ltd.;Coastal Greenland	沿海家园
Lai Fung Holdings Ltd.;Lai Fung	丽丰控股
Dream International Ltd.;Dream International	德林国际
Lion Rock Group Limited;Lion Rock	狮子山集团
Wynn Macau,Limited;Wynn Macau,Limited	永利澳门
China Water Industry Group Limited;China Water Industry	中国水业集团
China Environmental Resources Group Limited;China Environmental Resources	中国环境资源
Agritrade Resources Limited;Agritrade Resources	鸿宝资源
Orange Sky Golden Harvest Entertainment (Holdings) Limited;Orange Sky Golden Harvest Entertainment	橙天嘉禾
Harbin Electric Company Limited;Harbin Electric	哈尔滨电气
Asia Satellite Telecommunications Holdings Ltd.;Asia Satellite Telecommunications	ASIA SATELLITE
Hong Kong Television Network Ltd;Hong Kong Television Network	香港电视
COSCO SHIPPING Energy Transportation Co., Ltd.;COSCO SHIPPING Energy Transportation	中远海能
Victory Group Ltd.;Victory Group	华多利集团
OP Financial Limited;OP Financial	东英金融
Cmbc Capital Holdings Limited;Cmbc Capital	民银资本
Siberian Mining Group Company Limited;Siberian Mining	西伯利亚矿业
China Healthcare Enterprise Group Limited;China Healthcare Enterprise	华夏健康产业
Courage Investment Group Limited;Courage Investment	勇利投资
China Outfitters Holdings Limited;China Outfitters	中国服饰控股
Xinchen China Power Holdings Limited;Xinchen China Power	新晨动力
Anxin-China Holdings Limited;Anxin-China	中国安芯
Milan Station Holdings Limited;Milan Station	米兰站
Elec & Eltek International Company Limited;Elec & Eltek International	依利安达
Momentum Financial Holdings Limited;Momentum Financial	正乾金融控股
Centron Telecom International Holding Limited;Centron Telecom	星辰通信
Zoomlion Heavy Industry Science and Technology Co., Ltd.;Zoomlion Heavy Industry Science and Technology	中联重科
Starlight Culture Entertainment Group Limited;Starlight Culture Entertainment	星光文化
Grand Investment International Ltd.;Grand Investment	大唐投资国际
Water Oasis Group Ltd.;Water Oasis	奥思集团
CGN Mining Company Limited;CGN Mining	中广核矿业
Shunfeng International Clean Energy Limited;Shunfeng International Clean Energy	顺风清洁能源
Solartech International Holdings Ltd.;Solartech	星凯控股
Sinolink Worldwide Holdings Ltd.;Sinolink Worldwide	百仕达控股
Haier Electronics Group Co.,Limited;Haier Electronics Group Co.,Limited	海尔电器
Kingmaker Footwear Holdings Ltd.;Kingmaker Footwear	信星集团
Yanzhou Coal Mining Company Limited;Yanzhou Coal Mining	兖州煤业股份
Magnus Concordia Group Limited;Magnus Concordia	融太集团
Veeko International Holdings Ltd;Veeko International	威高国际
Pacific Andes International Holdings Ltd.;Pacific Andes	太平洋恩利
Fresh Express Delivery Holdings Group Co., Limited;Fresh Express Delivery Holdings Group	鲜驰达控股
Zhuguang Holdings Group Company Limited;Zhuguang Holdings	珠光控股
Sino Biopharmaceutical Limited;Sino Biopharmaceutical	中国生物制药
Huiyin Holdings Group Limited;Huiyin	汇银控股集团
Paradise Entertainment Limited;Paradise Entertainment	汇彩控股
Tang Palace (China) Holdings Limited;Tang Palace	唐宫中国
Success Dragon International Holdings Limited;Success Dragon	胜龙国际
MECOM Power And Construction Limited;MECOM Power And Construction	澳能建设
S.A.S. Dragon Holdings Ltd.;S.A.S. Dragon	S.A.S. DRAGON
China Energine International (Holdings) Limited;China Energine International	中国航天万源
China Railway Construction Corporation Limited;China Railway Construction	中国铁建
Han Tang International Holdings Limited;Han Tang	汉唐国际控股
Hybrid Kinetic Group Limited;Hybrid Kinetic	正道集团
Rosedale Hotel Holdings Limited;Rosedale Hotel	珀丽酒店
Bolina Holding Co., Ltd.;Bolina	航标控股
China Gem Holdings Limited;China Gem	中国中石控股
Titan Petrochemicals Group Ltd.;Titan Petrochemicals	泰山石化
China Resources Gas Group Limited;China Resources Gas	华润燃气
Munsun Capital Group Limited;Munsun Capital	麦盛资本
Kingwell Group Limited;Kingwell	京维集团
Realord Group Holdings Limited;Realord	伟禄集团
China Hengshi Foundation Company Limited;China Hengshi Foundation	中国恒石
Royale Furniture Holdings Limited;Royale Furniture	皇朝家俬
COSCO SHIPPING Ports Limited;COSCO SHIPPING Ports	中远海运港口
Midland Holdings Limited;Midland	美联集团
Tesson Holdings Limited;Tesson	天臣控股
Chengdu PUTIAN Telecommunications Cable Company Limited;Chengdu PUTIAN Telecommunications Cable	成都普天电缆股份
Guangnan (Holdings) Ltd.;Guangnan	广南(集团)
CITIC Resources Holdings Limited;CITIC Resources	中信资源
Technovator International Limited;Technovator	同方泰德
SRE Group Limited;SRE Group	上置集团
MMG Limited;MMG	五矿资源
Christine International Holdings Limited;Christine	克莉丝汀
BYD Company Limited;BYD	比亚迪股份
Lifestyle International Holdings Ltd;Lifestyle	利福国际
Mobicon Group Ltd.;Mobicon	万保刚集团
Kai Yuan Holdings Limited;Kai Yuan	开源控股
Zhongyuan Bank Co.,Ltd;Zhongyuan Bank	中原银行
China Innovation Investment Limited;China Innovation Investment	中国创新投资
Easyknit International Holdings Ltd.;Easyknit	永义国际
Tenwow International Holdings Limited;Tenwow	天喔国际
Zhidao International (Holdings) Limited;Zhidao International	志道国际
Sino Hotels (Holdings) Ltd.;Sino Hotels	SINO HOTELS
Wang On Group Ltd.;Wang On	WANG ON GROUP
Symphony Holdings Ltd.;Symphony	新沣集团
C C Land Holdings Limited;C C Land	中渝置地
Lerado Financial Group Company Limited;Lerado Financial	隆成金融
China Investment and Finance Group Limited;China Investment and Finance	中国投融资
National Investments Fund Limited;National Investments Fund	国盛投资
Superb Summit International Group Limited;Superb Summit	奇峰国际
Nan Nan Resources Enterprise Limited;Nan Nan Resources Enterprise	南南资源
Yashili International Holdings Ltd;Yashili	雅士利国际
Newton Resources Ltd;Newton Resources	新矿资源
Golden Wheel Tiandi Holdings Company Limited;Golden Wheel Tiandi	金轮天地控股
Times China Holdings Limited;Times China	时代中国控股
China Lilang Limited;China Lilang	中国利郎
Travel Expert (Asia) Enterprises limited;Travel Expert (Asia) Enterprises	专业旅运
National Agricultural Holdings Limited;National Agricultural	国农控股
China Environmental Technology and Bioenergy Holdings Limited;China Environmental Technology and Bioenergy	中科生物
Powerlong Real Estate Holdings Limited;Powerlong Real Estate	宝龙地产
Teamway International Group Holdings Limited;Teamway International	TEAMWAY INTL GP
CNQC International Holdings Limited;CNQC International	青建国际
Shuanghua Holdings Limited;Shuanghua	双桦控股
Wang On Properties Limited;Wang On Properties	宏安地产
Niraku GC Holdings, Inc.;Niraku GC Holdings	NIRAKU
Boill Healthcare Holdings Limited;Boill Healthcare	保集健康
Miko International Holdings Limited;Miko International	米格国际控股
Tonly Electronics Holdings Limited;Tonly Electronics	通力电子
Beijing Enterprises Clean Energy Group Limited;Beijing Enterprises Clean Energy	北控清洁能源集团
SPT Energy Group Inc.;SPT Energy Group	华油能源
China Tianrui Group Cement Company Limited;China Tianrui Group Cement	中国天瑞水泥
China Greenland Broad Greenstate Group Company Limited;China Greenland Broad Greenstate	中国绿地博大绿泽
S. Culture International Holdings Limited;S. Culture	港大零售
China Everbright Greentech Limited;China Everbright Greentech	中国光大绿色环保
China Nonferrous Mining Corporation Limited;China Nonferrous Mining	中国有色矿业
China Child Care Corporation Limited;China Child Care	中国儿童护理
Wonderful Sky Financial Group Holdings Limited;Wonderful Sky Financial	皓天财经集团
Labixiaoxin Snacks Group Limited;Labixiaoxin Snacks	蜡笔小新食品
PC Partner Group Limited;PC Partner	栢能集团
Tianjin Jinran Public Utilities Company Limited;Tianjin Jinran Public Utilities	天津津燃公用
Xiwang Special Steel Company Limited;Xiwang Special Steel	西王特钢
China Meidong Auto Holdings Limited;China Meidong Auto	美东汽车
China First Capital Group Limited;China First Capital	首控集团
Langham Hospitality Inv and Langham Hospitality Inv Ltd.-SS;Langham Hospitality Inv and Langham Hospitality Inv	朗廷-SS
Grand Ming Group Holdings Limited;Grand Ming	佳明集团控股
Datang Environment Industry Group Co., Ltd.;Datang Environment Industry	大唐环境
Hong Kong Finance Group Limited;Hong Kong Finance	香港信贷
Kinetic Mines and Energy Limited;Kinetic Mines and Energy	力量能源
China New Town Development Company Limited;China New Town Development	中国新城镇
Huiyin Smart Community Co., Ltd.;Huiyin Smart Community	汇银智慧社区
Longi Tech Smart Energy Holding Limited;Longi Tech Smart Energy	隆基泰和智慧能源
China Goldjoy Group Limited;China Goldjoy	中国金洋
Jiashili Group Limited;Jiashili	嘉士利集团
Agricultural Bank of China Limited;Agricultural Bank of China	农业银行
Wuxi Shenglida Mechanical Engineering Co., Ltd.;Wuxi Shenglida Mechanical Engineering	盛力达科技
China Huirong Financial Holdings Limited;China Huirong Financial	中国汇融
Changan Minsheng APLL Logistics Co.,Ltd.;Changan Minsheng APLL Logistics	长安民生物流
Grand Baoxin Auto Group Limited;Grand Baoxin Auto	广汇宝信
Guodian Technology & Environment Group Corporation Limited;Guodian Technology & Environment	国电科环
Sinosoft Technology Group Limited;Sinosoft Technology	中国擎天软件
Techcomp (Holdings) Limited;Techcomp	天美(控股)
AIA Group Limited;AIA Group	友邦保险
Trigiant Group Limited;Trigiant	俊知集团
D&G Technology Holding Company Limited;D&G Technology Holding	德基科技控股
LifeTech Scientific Corporation;LifeTech Scientific	先健科技
Huili Resources (Group) Limited;Huili Resources	汇力资源
Wai Chi Holdings Company Limited;Wai Chi	伟志控股
SITC International Holdings Company Limited;SITC International	海丰国际
HKBN Ltd.;HKBN	香港宽频
Tongfang Kontafarma Holdings Limited;Tongfang Kontafarma	同方康泰
China Resources Cement Holdings Limited;China Resources Cement	华润水泥控股
Tsui Wah Holdings Limited;Tsui Wah	翠华控股
Vision Fame International Holding Limited;Vision Fame	允升国际
Nexteer Automotive Group Limited;Nexteer Automotive	耐世特
China Maple Leaf Educational Systems Limited;China Maple Leaf Educational Systems	枫叶教育
Greens Holdings Ltd;Greens	格菱控股
Oi Wah Pawnshop Credit Holdings Limited;Oi Wah Pawnshop Credit	霭华押业信贷
China New City Commercial Development Limited;China New City Commercial Development	中国新城市
CW Group Holdings Limited;CW Group	创达科技控股
Newtree Group Holdings Limited;Newtree	NEWTREE GROUP
Transmit Entertainment Limited;Transmit Entertainment	传递娱乐
Time2U International Holding Limited;Time2U	时间由你
International Elite LTD.;International Elite	精英国际
Beijing Capital Grand Limited;Beijing Capital Grand	首创钜大
Dynagreen Environmental Protection Group Co., Ltd.;Dynagreen Environmental Protection	绿色动力环保
China Touyun Tech Group Limited;China Touyun Tech	中国透云
China Zhongwang Holdings Limited;China Zhongwang	中国忠旺
Sheen Tai Holdings Group Company Limited;Sheen Tai Holdings	顺泰控股
New China Life Insurance Company Ltd.;New China Life Insurance	新华保险
Razer Inc.;Razer	雷蛇
BaWang International (Group) Holding Ltd.;BaWang International	霸王集团
The People's Insurance Company (Group) of China Limited;People's Insurance Company (Group) of China	中国人民保险集团
Huisheng International Holdings Limited;Huisheng	惠生国际
Hao Tian International Construction Investment Group Limited;Hao Tian International Construction Investment	昊天国际建投
China Pioneer Pharma Holdings Limited;China Pioneer Pharma	中国先锋医药
Hua Hong Semiconductor Limited;Hua Hong Semiconductor	华虹半导体
Quali-Smart Holdings Limited;Quali-Smart	滉达富控股
Shanghai Fudan-Zhangjiang Bio-Pharmaceutical Co., Ltd.;Shanghai Fudan-Zhangjiang Bio-Pharmaceutical	复旦张江
Fujian Nuoqi Co., Ltd.;Fujian Nuoqi	诺奇
Legend Strategy International Holdings Group Company Limited;Legend Strategy International Holdings	朸浚国际
Meitu, Inc.;Meitu	美图公司
PW Medtech Group Limited;PW Medtech	普华和顺
China Cinda Asset Management Co.,Ltd.;China Cinda Asset Management	中国信达
Mega Expo Holdings Limited;Mega Expo	MEGAEXPO HLDG
361 Degrees International Limited;361 Degrees	361度
SiS Mobile Holdings Limited;SiS Mobile	新龙移动
CT Environmental Group Limited;CT Environmental	中滔环保
China Rundong Auto Group Limited;China Rundong Auto	润东汽车
Jiangnan Group Limited;Jiangnan	江南集团
SFund International Holdings Limited;SFund International	广州基金国际控股
Xtep International Holdings Limited;Xtep	特步国际
Wuzhou International Holdings Limited;Wuzhou	五洲国际
Aowei Holding Limited;Aowei Holdings	奥威控股
China LotSynergy Holdings Limited;China LotSynergy	华彩控股
Bisu Technology Group International Limited;Bisu Technology	比速科技
International Housewares Retail Company Limited;International Housewares Retail	国际家居零售
Central China Securities Co., Ltd.;Central China Securities	中州证券
China Hongqiao Group Limited;China Hongqiao	中国宏桥
China Kingstone Mining Holdings Limited;China Kingstone Mining	中国金石
Canvest Environmental Protection Group Company Limited;Canvest Environmental Protection	粤丰环保
Pacific textiles holdings Limited;Pacific textiles	互太纺织
Suncity Group Holdings Limited;Suncity	太阳城集团
Shanghai Fudan Microelectronics Group Company Limited;Shanghai Fudan Microelectronics	上海复旦
Vestate Group Holdings Limited;Vestate	国投集团控股
Renhe Commercial Holdings Co. Ltd.;Renhe Commercial	人和商业
Embry Holdings Ltd;Embry Holdings	安莉芳控股
Major Holdings Limited;Major Holdings	美捷汇控股
Hidili Industry International Development Ltd;Hidili Industry International Development	恒鼎实业
Ell Environmental Holdings Limited;Ell Environmental	强泰环保
Hydoo International Holding Limited;Hydoo International	毅德国际
Baguio Green Group Limited;Baguio Green	碧瑶绿色集团
Industrial and Commercial Bank of China Limited;Industrial and Commercial Bank of China	工商银行
Scud Group Limited;Scud Group	飞毛腿
Moody Technology Holdings Limited;Moody Technology	满地科技股份
Cowell e Holdings Inc.;Cowell e Holdings	高伟电子
Riverine China Holdings Limited;Riverine China	浦江中国
Sinomax Group Limited;Sinomax	盛诺集团
Human Health Holdings Limited;Human Health	盈健医疗
Chuan Holdings Limited;Chuan Holdings	川控股
Kingbo Strike Limited;Kingbo Strike	工盖有限公司
Bright Smart Securities & Commodities Group Limited;Bright Smart Securities & Commodities	耀才证券金融
Suchuang Gas Corporation Limited;Suchuang Gas	苏创燃气
YuanShengTai Dairy Farm Limited;YuanShengTai Dairy Farm	原生态牧业
China Shengmu Organic Milk Limited;China Shengmu Organic Milk	中国圣牧
Mobile Internet (China) Holdings Limited;Mobile Internet	移动互联(中国)
Fulum Group Holdings Limited;Fulum Group	富临集团控股
Hung Fook Tong Group Holdings Limited;Hung Fook Tong	鸿福堂
SFK Construction Holdings Limited;SFK Construction	新福港
Fu Shou Yuan International Group Limited;Fu Shou Yuan	福寿园
Century Sage Scientific Holdings Limited;Century Sage Scientific	世纪睿科
MS Group Holdings Limited;MS Group	万成集团股份
Denox Environmental & Technology Holdings Limited;Denox Environmental & Technology	迪诺斯环保
Guolian Securities Co., Ltd.;Guolian Securities	国联证券
Zhou Hei Ya International Holdings Company Limited;Zhou Hei Ya International	周黑鸭
Jujiang Construction Group Co., Ltd.;Jujiang Construction	巨匠建设
ICO Group Limited;ICO Group	扬科集团
Luzheng Futures Company Limited;Luzheng Futures	鲁证期货
Gold-Finance Holdings Limited;Gold-Finance	金诚控股
Affluent Partners Holdings Limited;Affluent Partners	钱唐控股
UKF (Holdings) Limited;UKF Holdings	英裘控股
Get Nice Financial Group Limited;Get Nice Financial	结好金融
Prosper One International Holdings Company Limited;Prosper One International	富一国际控股
Nissin Foods Company Limited;Nissin Foods	日清食品
Hengtai Securities Co.,Ltd.;Hengtai Securities	恒投证券
Q Technology (Group) Company Limited;Q Technology	丘钛科技
Yan Tat Group Holdings Limited;Yan Tat	恩达集团控股
U Banquet Group Holding Limited;U Banquet	誉宴集团
C Cheng Holdings Limited;C Cheng	思城控股
Best Food Holding Company Limited;Best Food Holding	百福控股
China Zhongdi Dairy Holdings Company Limited;China Zhongdi Dairy	中地乳业
Jiyi Household International Holdings Limited;Jiyi Household	集一家居
Ap Rentals Holdings Limited;Ap Rentals	亚积邦租赁
PuraPharm Corporation Limited;PuraPharm	培力控股
LEAP Holdings Group Limited;LEAP Holdings	前进控股集团
In Construction Holdings Limited;In Construction	现恒建筑
China Reinsurance (Group) Corporation;China Reinsurance	中国再保险
Harmonicare Medical Holdings Limited;Harmonicare Medical	和美医疗
Livzon Pharmaceutical Group Inc.;Livzon Pharmaceutical Group	丽珠医药
China Resources Phoenix Healthcare Holdings Company Limited;China Resources Phoenix Healthcare	华润凤凰医疗
New Century Healthcare Holding Co. Limited;New Century Healthcare Holding	新世纪医疗
CEFC Hong Kong Financial Investment Company Limited;CEFC Hong Kong Financial Investment	华信金融投资
BII Railway Transportation Technology Holdings Company Limited;BII Railway Transportation Technology	京投交通科技
Plover Bay Technologies Limited;Plover Bay Technologies	珩湾科技
Rici Healthcare Holdings Limited;Rici Healthcare	瑞慈医疗
Zhejiang Tengy Environmental Technology Co., Ltd;Zhejiang Tengy Environmental Technology	天洁环境
Red Star Macalline Group Corporation Ltd.;Red Star Macalline Group	红星美凯龙
3SBio Inc.;3SBio	三生制药
China Partytime Culture Holdings Limited;China Partytime Culture	中国派对文化
Lanzhou Zhuangyuan Pasture Co., Ltd.;Lanzhou Zhuangyuan Pasture	庄园牧场
Yuk Wing Group Holdings Limited;Yuk Wing	煜荣集团
Zhong Ao Home Group Limited;Zhong Ao Home	中奥到家
Synergy Group Holdings International Limited;Synergy	汇能集团
Guangdong Join-Share Financing Guarantee Investment Co., Ltd.;Guangdong Join-Share Financing Guarantee Investment	中盈盛达融资担保
Thelloy Development Group Limited;Thelloy Development	德莱建业
Ibi Group Holdings Limited;Ibi Group	IBI GROUP HLDGS
Genscript Biotech Corporation;Genscript Biotech	金斯瑞生物科技
Ever Harvest Group Holdings Limited;Ever Harvest	永丰集团控股
Guangzhou Rural Commercial Bank Co.,Ltd;Guangzhou Rural Commercial Bank	广州农商银行
Bhcc Holding Limited;Bhcc  Holding	BHCC HOLDING
MIE Holdings Corporation;MIE Holdings	MI能源
Chinney Kin Wing Holdings Limited;Chinney Kin Wing	建业建荣
K.H. Group Holdings Limited;K.H. Group	剑虹集团控股
Yichang Hec Changjiang Pharmaceutical Co., Ltd.;Yichang Hec Changjiang Pharmaceutical	东阳光药
Kwan On Holdings Limited;Kwan On	均安控股
Star Properties Group (Cayman Islands) Limited;Star Properties	星星地产
Manfield Chemical Holdings Limited;Manfield Chemical	万辉化工
Virscend Education Company Limited;Virscend Education	成实外教育
China Animation Characters Company Limited;China Animation Characters	华夏动漫
Sundart Holdings Limited;Sundart	承达集团
Minsheng Education Group Co., Ltd.;Minsheng Education	民生教育
Weiye Holdings Limited;Weiye Holdings	伟业控股
Xin Point Holdings Limited;Xin Point	信邦控股
China Art Financial Holdings Limited;China Art Financial	中国艺术金融
China Unienergy Group Limited;China Unienergy	中国优质能源
Morris Holdings Limited;Morris	慕容控股
Qilu Expressway Company Limited;Qilu Expressway	齐鲁高速
Quanzhou Huixin Micro-Credit Co., Ltd.;Quanzhou Huixin Micro-Credit	汇鑫小贷
Bank of Tianjin Co., Ltd.;Bank of Tianjin	天津银行
Yihai International Holding Ltd.;Yihai International	颐海国际
Da Sen Holdings Group Limited;Da Sen	大森控股
Progressive P;Progressive P	进升集团控股
Qinqin Foodstuffs Group (Cayman) Company Limited;Qinqin Foodstuffs Group	亲亲食品
Yadea Group Holdings Ltd.;Yadea Group	雅迪控股
China Leon Inspection Holding Limited;China Leon Inspection	中国力鸿
Shineroad International Holdings Limited;Shineroad	欣融国际
Chanjet Information Technology Co., Ltd.;Chanjet Information Technology	畅捷通
China Logistics Property Holdings Co., Ltd;China Logistics Property	中国物流资产
Shun Wo Group Holdings Limited;Shun Wo	汛和集团
Anchorstone Holdings Limited;Anchorstone	基石控股
Hebei Yichen Industrial Group Corporation Limited;Hebei Yichen Industrial Group	翼辰实业
China 21st Century Education Group Limited;China 21st Century Education	21世纪教育
Beijing Urban Construction Design & Development Group Co.,Limtied;Beijing Urban Construction Design & Development	城建设计
China Tian Lun Gas Holdings Limited;China Tian Lun Gas	天伦燃气
China Development Bank Financial Leasing Co., Ltd;China Development Bank Financial Leasing	国银租赁
Vpower Group International Holdings Limited;Vpower	伟能集团
Chong Kin Group Holdings Limited;Chong Kin	创建集团控股
Cofco Meat Holdings Limited;Cofco Meat	中粮肉食
Pantronics Holdings Limited;Pantronics	桐成控股
Vincent Medical Holdings Limited;Vincent Medical	永胜医疗
Synertone Communication Corporation;Synertone Communication	协同通信
AB Builders Group Limited;AB Builders	奥邦建筑
Starrise Media Holdings Limited;Starrise Media	星宏传媒
Nanfang Communication Holdings Limited;Nanfang Communication	南方通信
Metallurgical Corporation of China Ltd.;Metallurgical Corporation of China	中国中冶
Tianhe Chemicals Group Limited;Tianhe Chemicals	天合化工
Cteh Inc.;Cteh	加达控股
Vico International Holdings Limited;Vico International	域高国际控股
Redco Properties Group Limited;Redco Properties	力高集团
Hilong Holding Limited;Hilong	海隆控股
Tourism International Holdings Limited;Tourism International	旅业国际
Able Engineering Holdings Limited;Able Engineering	安保工程控股
Yuzhou Properties Co. Ltd.;Yuzhou Properties	禹洲地产
Mengke Holdings Limited;Mengke	盟科控股
Kin Shing Holdings Limited;Kin Shing	建成控股
Ref Holdings Limited;Ref Holdings	REF HOLDINGS
Food Wise Holdings Limited;Food Wise	膳源控股
Sheung Yue Group Holdings Limited;Sheung Yue	上谕集团
Shanghai Dazhong Public Utilities(Group)Co.,Ltd;Shanghai Dazhong Public Utilities(Group)Co.,Ltd	大众公用
China Metal Resources Utilization Limited;China Metal Resources Utilization	中国金属利用
Sh Group (Holdings) Limited;Sh Group	顺兴集团控股
Kaisa Group Holdings Limited;Kaisa Group	佳兆业集团
AKM Industrial Company Limited;AKM Industrial	安捷利实业
Grandshores Technology Group Limited;Grandshores Technology	SHIS LTD
Inner Mongolia Energy Engineering Co.,Ltd.;Inner Mongolia Energy Engineering	内蒙古能建
Precision Tsugami (China) Corporation Limited;Precision Tsugami	津上机床中国
Fusen Pharmaceutical Company Limited;Fusen Pharmaceutical	福森药业
Okura Holdings Limited;Okura Holdings	OKURA HOLDINGS
Isdn Holdings Limited;Isdn Holdings	亿仕登控股
Postal Savings Bank of China Co., Ltd.;Postal Savings Bank of China	邮储银行
Haitian Energy International Limited;Haitian Energy	海天能源
Zhaobangji Properties Holdings Limited;Zhaobangji Properties	兆邦基地产
Wisdom Sports Group;Wisdom Sports	智美体育
Yee Hop Holdings Limited;Yee Hop	义合控股
Sino Harbour Holdings Group Limited;Sino Harbour	汉港控股
Pentamaster International Limited;Pentamaster	槟杰科达
Tong Ren Tang Technologies Co. Limited;Tong Ren Tang Technologies	同仁堂科技
Milestonebuilderholdingslimited;Milestonebuilderholdingslimited	进阶发展
China South City Holdings Limited;China South City	华南城
Global International Credit Group Limited;Global International Credit	环球信贷集团
Tianjin Tianbao Energy Co.,Ltd.;Tianjin Tianbao Energy	天保能源
Ascletis Pharma Inc.;Ascletis Pharma	歌礼制药-B
Huazhang Technology Holding Limited;Huazhang Technology	华章科技
China Shenghai Food Holdings Company Limited;China Shenghai Food	中国升海食品
China Creative Global Holdings Limited;China Creative Global	中创环球
Risecomm Group Holdings Limited;Risecomm	瑞斯康集团
Macau Legend Development Limited;Macau Legend Development	澳门励骏
Consun Pharmaceutical Group Limited;Consun Pharmaceutical	康臣药业
Hua Long Jin Kong Company Limited;Hua Long Jin Kong	华隆金控
Royal China International Holdings Limited;Royal China	皇中国际
Boer Power Holdings Limited;Boer Power	博耳电力
Sunevision Holdings Ltd.;Sunevision	新意网集团
Huaxi Holdings Company Limited;Huaxi Holdings	华禧控股
Lap Kei Engineering (Holdings) Limited;Lap Kei Engineering	立基工程控股
Bgmc International Limited;Bgmc International	璋利国际
S&P International Holding Limited;S&P International	椰丰集团
Sisram Medical Ltd;Sisram Medical	SISRAM MED
Shandong International Trust Co., Ltd.;Shandong International Trust	山东国信
Boshiwa International Holding Limited;Boshiwa	博士蛙国际
China Putian Food Holding Limited;China Putian Food	普甜食品
Springland International Holdings Limited;Springland	华地国际控股
Dongguang Chemical Limited;Dongguang Chemical	东光化工
B&S International Holdings Ltd.;B&S International	宾仕国际
Shuang Yun Holdings Limited;Shuang Yun	双运控股
Geotech Holdings Ltd.;Geotech	致浩达控股
Nanjing Sample Technology Company Limited;Nanjing Sample Technology	三宝科技
Season Pacific Holdings Limited;Season Pacific	云裳衣
Trio Industrial Electronics Group Limited;Trio Industrial Electronics	致丰工业电子
Ulferts International Limited;Ulferts	欧化
Miji International Holdings Limited;Miji International	米技国际控股
Most Kwai Chung Limited;Most Kwai Chung	毛记葵涌
Ausnutria Dairy Corporation Ltd.;Ausnutria Dairy	澳优
Wan Kei Group Holdings Limited;Wan Kei	宏基集团控股
China Infrastructure & Logistics Group Ltd.;China Infrastructure & Logistics	中国通商集团
Putian Communication Group Limited;Putian Communication	普天通信集团
FSM Holdings Limited;FSM Holdings	FSM HOLDINGS
Kin Pang Holdings Limited;Kin Pang	建鹏控股
Eternity Technology Holdings Limited;Eternity Technology	恒达科技控股
HKE Holdings Limited;HKE Holdings	HKE HOLDINGS
Hebei Construction Group Corporation Limited;Hebei Construction Group	河北建设
China ZhengTong Auto Services Holdings Limited;China ZhengTong Auto Services	正通汽车
Time Interconnect Technology Limited;Time Interconnect Technology	汇聚科技
LHN Limited;LHN	LHN
Prosperous Industrial (Holdings) Limited;Prosperous Industrial	其利工业集团
E-Commodities Holdings Limited;E-Commodities	易大宗
Wang Yang Holdings Limited;Wang Yang	泓盈控股
A & S Group (Holdings) Limited;A&S Group	亚洲实业集团
Feishang Anthracite Resources Limited;Feishang Anthracite Resources	飞尚无烟煤
Qeeka Home (Cayman) Inc.;Qeeka Home	齐屹科技
HPC Holdings Limited;HPC Holdings	HPC HOLDINGS
Man Shun Group (Holdings) Limited;Man Shun	万顺集团控股
Shanshan Brand Management Co., Ltd.;Shanshan Brand Management	杉杉品牌
REM Group (Holdings) Limited;REM Group	全达电器集团控股
Sing On Holdings Limited;Sing On	成安控股
Top Education Group Ltd;Top Education	澳洲成峰高教
Affluent Foundation Holdings Limited;Affluent Foundation	俊裕地基
Bojun Education Company Limited;Bojun Education	博骏教育
Intron Technology Holdings Limited;Intron Technology	英恒科技
China Isotope & Radiation Corporation;China Isotope & Radiation	中国同辐
Hope Education Group Co.,Ltd.;Hope Education Group	希望教育
CRRC Corporation Limited;CRRC	中国中车
Sunfonda Group Holdings Limited;Sunfonda	新丰泰集团
Tianli Education International Holdings Limited;Tianli Education	天立教育
BExcellent Group Holdings Limited;BExcellent	精英汇集团
GF Securities Co., Ltd.;GF Securities	广发证券
Fantasia Holdings Group Co., Limited;Fantasia Holdings Group	花样年控股
Colour Life Services Group Co., Limited;Colour Life Services Group	彩生活
Golden Ponder Holdings Limited;Golden Ponder	金仑控股有限公司
CRCC High-Tech Equipment Corporation Limited;CRCC High-Tech Equipment	铁建装备
Guotai Junan International Holdings Limited;Guotai Junan	国泰君安国际
Ak Medical Holdings Limited;Ak Medical	爱康医疗
China Datang Corporation Renewable Power Co.,Limited;China Datang Corporation Renewable Power	大唐新能源
Xinte Energy Co., Ltd.;Xinte Energy	新特能源
China Communications Construction Company Limited;China Communications Construction	中国交通建设
Beijing Sports and Entertainment Industry Group Limited;Beijing Sports and Entertainment Industry	北京体育文化
Huifu Payment Limited;Huifu Payment	汇付天下
Enterprise Development Holdings Limited;Enterprise Development	企展控股
Xiaomi Corporation;Xiaomi	小米集团-W
CGN New Energy Holdings Co., Ltd.;CGN New Energy	中广核新能源
Shandong Chenming Paper Holdings Limited;Shandong Chenming Paper	晨鸣纸业
KWG Group Holdings Limited;KWG Group	合景泰富集团
CSMall Group Limited;CSMall	金猫银猫
CGN Power Co.,Ltd.;CGN Power	中广核电力
Zhaojin Mining Industry Company Limited;Zhaojin Mining Industry	招金矿业
Rich Bird Co.,Ltd;Rich Bird	富贵鸟
HongDa Financial Holding Limited;HongDa Financial	弘达金融控股
Huayu Expressway Group Limited;Huayu Expressway	华昱高速
Dafy Holdings Limited;Dafy	达飞控股
Dah Chong Hong Holdings Limited;Dah Chong Hong	大昌行集团
China Machinery Engineering Corporation;China Machinery Engineering	中国机械工程
Perfect Shape Medical Limited;Perfect Shape Medical	必瘦站
Shifang Holding Limited;Shifang	十方控股
Ping An Healthcare And Technology Company Limited;Ping An Healthcare And Technology	平安好医生
Stella International Holdings Ltd;Stella International	九兴控股
China Properties Group Limited;China Properties	CHINAPROPERTIES
China Aircraft Leasing Group Holdings Limited;China Aircraft Leasing	中国飞机租赁
Ernest Borel Holdings Limited;Ernest Borel	依波路
Beijing Chunlizhengda Medical Instruments Co., Ltd.;Beijing Chunlizhengda Medical Instruments	春立医疗
Jingrui Holdings Limited;Jingrui	景瑞控股
China Longevity Group Company Limited;China Longevity	中国龙天集团
China XLX Fertiliser Ltd.;China XLX Fertiliser	中国心连心化肥
Neo-Neon Holdings Limited;Neo-Neon	同方友友
Li Bao Ge Group Limited;Li Bao Ge	利宝阁集团
SouthGobi Resources Limited;SouthGobi Resources	南戈壁-S
Haitian International Holdings Limited;Haitian	海天国际
Citic Telecom International Holdings Limited;Citic Telecom	中信国际电讯
Eprint Group Limited;Eprint	EPRINT集团
China Wood Optimization (Holding) Limited;China Wood Optimization	中国优材
China Huiyuan Juice Group Limited;China Huiyuan Juice	汇源果汁
Kingboard Laminates Holdings Limited;Kingboard Laminates	建滔积层板
Sanai Health Industry Group Company Limited;Sanai Health Industry	三爱健康集团
China Coal Energy Company Limited;China Coal Energy	中煤能源
Xingda International Holdings Ltd.;Xingda	兴达国际
China ITS (Holdings) Co., Ltd;China ITS	中国智能交通
C&D International Investment Group Limited;C&D International Investment	建发国际集团
Samsonite International S.A.;Samsonite International S.A.	新秀丽
PRADA S.p.A.;PRADA S.p.A.	普拉达
Jiangxi Bank Co., Ltd.;Jiangxi Bank	江西银行
Sunac China Holdings Limited;Sunac China	融创中国
COSCO SHIPPING HoldingsCo., Ltd.;COSCO SHIPPING	中远海控
Sands China Ltd.;Sands China	金沙中国有限公司
Chow Tai Fook Jewellery Group Limited;Chow Tai Fook Jewellery	周大福
Cpm Group Limited;Cpm Group	中漆集团
Oneforce Holdings Limited;Oneforce	元力控股
Chu Kong Petroleum and Natural Gas Steel Pipe Holdings Ltd;Chu Kong Petroleum and Natural Gas Steel Pipe	珠江钢管
Baic Motor Corporation Limited;Baic Motor	北京汽车
Evergreen Products Group Limited;Evergreen Products	训修实业
Bank of Chongqing Co., Ltd.;Bank of Chongqing	重庆银行
China SCE Group Holdings Limited;China SCE	中骏集团控股
Hingtex Holdings Limited;Hingtex	兴纺控股
China Chunlai Education Group Co.,Ltd.;China Chunlai Education Group	中国春来
Imax China Holding, Inc.;Imax China Holding	IMAX CHINA
Swire Properties Limited;Swire Properties	太古地产
Sun Hing Printing Holdings Limited;Sun Hing Printing	新兴印刷
LH Group Limited;LH Group	叙福楼集团
Ten Pao Group Holdings Limited;Ten Pao	天宝集团
Tian Ge Interactive Holdings Limited;Tian Ge Interactive	天鸽互动
Nameson Holdings Limited;Nameson	南旋控股
Microware Group Limited;Microware	美高域
Tsaker Chemical Group Limited;Tsaker Chemical	彩客化学
China Minsheng Banking Corp., Ltd.;China Minsheng Banking	民生银行
Pine Care Group Limited;Pine Care	松龄护老集团
Xinghua Port Holdings Ltd.;Xinghua Port	兴华港口
Ta Yang Group Holdings Limited;Ta Yang	大洋集团
Asiaray Media Group Limited;Asiaray Media	雅仕维
Redsun Properties Group Limited;Redsun Properties	弘阳地产
Wharf Real Estate Investment Company Limited;Wharf Real Estate Investment	九龙仓置业
Flyke International Holdings Ltd;Flyke International	飞克国际
Man Wah Holdings Limited;Man Wah	敏华控股
Sim Technology Group Limited;Sim Technology	晨讯科技
China New Higher Education Group Limited;China New Higher Education	新高教集团
China Sunshine Paper Holdings Company Limited;China Sunshine Paper	阳光纸业
Vcredit Holdings Limited;Vcredit	维信金科
SSY Group Limited;SSY Group	石四药集团
Shanghai Jin Jiang International Hotels (Group) Company Limited;Shanghai Jin Jiang International Hotels	锦江酒店
Country Garden Holdings Co. Ltd;Country Garden	碧桂园
Phoenix Media Investment (Holdings) Limited;Phoenix Media Investment	凤凰卫视
BBMG Corporation;BBMG	金隅集团
Real Nutriceutical Group Limited;Real Nutriceutical	瑞年国际
Kee Holdings Company Limited;Kee Holdings	KEE
Sunshine Oilsands Ltd.;Sunshine Oilsands	阳光油砂
Ozner Water International Holding Limited;Ozner Water	浩泽净水
China Zheshang Bank Co.,Ltd.;China Zheshang Bank	浙商银行
Chanhigh Holdings Limited;Chanhigh	沧海控股
AAC Technologies Holdings Inc.;AAC Technologies Holdings	瑞声科技
ANTA Sports Products Limited;ANTA Sports Products	安踏体育
Digital Hollywood Interactive Limited;Digital Hollywood Interactive	游莱互动
China Ludao Technology Company Limited;China Ludao Technology	中国绿岛科技
Ruifeng Power Group Company Limited;Ruifeng Power	瑞丰动力
Jolimark Holdings Limited;Jolimark	映美控股
Cabbeen Fashion Limited;Cabbeen Fashion	卡宾
Ausupreme International Holdings Limited;Ausupreme	澳至尊
Time Watch Investments Limited;Time Watch Investments	时计宝
FIH Mobile Limited;FIH Mobile	富智康集团
China International Marine Containers (Group) Co., Ltd;China International Marine Containers	中集集团
E-House (China) Enterprise Holdings Limited;E-House (China) Enterprise	易居企业控股
51 Credit Card Inc.;51 Credit Card	51信用卡
Shengjing Bank Co., Ltd.;Shengjing Bank	盛京银行
China Aluminum International Engineering Corporation Limited;China Aluminum International Engineering	中铝国际
PanAsialum Holdings Company Limited;PanAsialum	荣阳实业
AUX International Holdings Limited;AUX International	奥克斯国际
Nature Home Holding Company Limited;Nature Home Holding	大自然家居
HNA Technology Investments Holdings Limited;HNA Technology Investments	海航科技投资
Xiwang Property Holdings Company Limited;Xiwang Property	西王置业
Zall Smart Commerce Group Ltd.;Zall Smart Commerce	卓尔智联
China Gold International Resources Corp. Ltd.;China Gold International Resources	中国黄金国际
Baioo Family Interactive Limited;Baioo Family Interactive	百奥家庭互动
Best Pacific International Holdings Limited;Best Pacific	超盈国际控股
CAA Resources Limited;CAA Resources	优库资源
Cherish Holdings Limited;Cherish Holdings	东盈控股
Jiangsu Innovative Ecological New Materials Limited;Jiangsu Innovative Ecological New Materials	江苏创新
Tian Shan Development (Holding) Limited;Tian Shan Development	天山发展控股
Tsit Wing International Holdings Limited;Tsit Wing	捷荣国际控股
Wenzhou Kangning Hospital Co., Ltd.;Wenzhou Kangning Hospital	康宁医院
China First Chemical Holdings Limited;China First Chemical	一化控股
Kidsland International Holdings Limited;Kidsland	凯知乐国际
Golden Shield Holdings (Industrial) Limited;Golden Shield Holdings (Industrial)	金盾控股
China Lesso Group Holdings Limited;China Lesso	中国联塑
China Polymetallic Mining Limited;China Polymetallic Mining	中国多金属
Lifestyle China Group Limited;Lifestyle China	利福中国
Union Medical Healthcare Limited;Union Medical Healthcare	香港医思医疗集团
Bank of Gansu Co.,Ltd.;Bank of Gansu	甘肃银行
Smart-Core Holdings Limited;Smart-Core	芯智控股
Petro-king Oilfield Services Limited;Petro-king Oilfield Services	百勤油服
Tian Chang Group Holdings Ltd.;Tian Chang	天长集团
Sansheng Holdings (Group) Co. Ltd.;Sansheng Holdings	三盛控股
Luye Pharma Group Ltd.;Luye Pharma	绿叶制药
China Titans Energy Technology Group Co., Ltd;China Titans Energy Technology	泰坦能源技术
Man King Holdings Limited;Man King	万景控股
Shanghai Fosun Pharmaceutical (Group) Co., Ltd.;Shanghai Fosun Pharmaceutical	复星医药
China Sanjiang Fine Chemicals Company Limited;China Sanjiang Fine Chemicals	中国三江化工
Regina Miracle International (Holdings) Limited;Regina Miracle International	维珍妮
Hosa International Limited;Hosa International	浩沙国际
China Vanke Co.,Ltd.;China Vanke	万科企业
Top Dynamic International Holdings Limited;Top Dynamic	泰邦集团
Xinjiang Goldwind Science&Technology Co.,Ltd;Xinjiang Goldwind Science&Technology	金风科技
Universal Health International Group Holding Limited;Universal Health International	大健康国际
Future Bright Mining Holdings Limited;Future Bright Mining	高鹏矿业
Yi Hua Holdings Limited;YiHua	益华控股
Yantai North Andre Juice Co. Limited;Yantai North Andre Juice	安德利果汁
New Concepts Holdings Limited;New Concepts	创业集团控股
Nvc Lighting Holding Limited;Nvc Lighting	雷士照明
Casablanca Group Limited;Casablanca	卡撒天娇
Kakiko Group Limited;Kakiko	KAKIKO GROUP
Honworld Group Limited;Honworld	老恒和酿造
Solis Holdings Limited;Solis Holdings	守益控股
Cecep Costin New Materials Group Limited;Cecep Costin New Materials	中国节能海东青
Changgang Dunxin Enterprise Company Limited;Changgang Dunxin Enterprise	长港敦信
Crystal International Group Limited;Crystal International	晶苑国际
West China Cement Limited;West China Cement	西部水泥
Wison Engineering Services Co. Ltd.;Wison Engineering Services	惠生工程
Guangzhou Automobile Group Co., Ltd.;Guangzhou Automobile	广汽集团
Smit Holdings Limited;Smit Holdings	国微技术
Haichang Ocean Park Holdings Ltd.;Haichang Ocean Park	海昌海洋公园
Steve Leung Design Group Limited;Steve Leung Design	梁志天设计集团
Lai Si Enterprise Holding Limited;Lai Si Enterprise	黎氏企业
Youyuan International Holdings Limited;Youyuan	优源控股
Wuxi Biologics (Cayman) Inc;Wuxi Biologics	药明生物
Huarong Investment Stock Corporation Limited;Huarong Investment Stock	华融投资股份
Hailan Holdings Limited;Hailan	海蓝控股
HC Group Inc.;HC Group	慧聪集团
Luzhou Xinglu Water (Group) Co.,Ltd.;Luzhou Xinglu Water	兴泸水务
MGM China Holdings Limited;MGM China	美高梅中国
Tk Group (Holdings) Limited;Tk Group	东江集团控股
Chen Xing Development Holdings Limited;Chen Xing Development	辰兴发展
Rykadan Capital Limited;Rykadan Capital	宏基资本
Charmacy Pharmaceutical Co., Ltd.;Charmacy Pharmaceutical	创美药业
Thing On Enterprise Limited;Thing On Enterprise	晋安实业
Bamboos Health Care Holdings Limited;Bamboos Health Care	百本医护
Cosmo Lady (China) Holdings Company Limited;Cosmo Lady	都市丽人
Billion Industrial Holdings Limited;Billion Industrial	百宏实业
AMVIG Holdings Limited;AMVIG	澳科控股
CNNC International Limited;CNNC International	中核国际
Hengxing Gold Holding Company Limited;Hengxing Gold Holding	恒兴黄金
Kam Hing International Holdings Ltd;Kam Hing	锦兴国际控股
EVOC Intelligent Technology Company Limited;EVOC Intelligent Technology	研祥智能
Birmingham Sports Holdings Limited;Birmingham Sports	伯明翰体育
Forebase International Holdings Limited;Forebase	申基国际
China Financial Leasing Group Limited;China Financial Leasing	中国金融租赁
Shenzhou International Group Holdings Ltd.;Shenzhou International	申洲国际
Lee & Man Paper Manufacturing Ltd.;Lee & Man Paper Manufacturing	理文造纸
Vedan International (Holdings) Ltd.;Vedan International	味丹国际
Ping An Insurance (Group) Company of China, Ltd.;Ping An Insurance (Group) Company of China	中国平安
China Mengniu Dairy Co. Ltd.;China Mengniu Dairy	蒙牛乳业
Hop Fung Group Holdings Ltd.;Hop Fung	合丰集团
Noble Century Investment Holdings Limited;Noble Century Investment	仁瑞投资
HKBridge Financial Holdings Limited;HKBridge Financial	中国港桥
Capital VC Limited;Capital VC	首都创投
New Provenance Everlasting Holdings Limited;New Provenance Everlasting	新源万恒控股
Meilleure Health International Industry Group Limited;Meilleure Health International Industry	美瑞健康国际
PICC Property and Casualty Company Limited;PICC Property and Casualty	中国财险
Guorui Properties Limited;Guorui Properties	国瑞置业
China Uptown Group Company Limited;China Uptown	中国上城
Li Ning Co. Ltd.;Li Ning;Lining	李宁
Great Wall Motor Company Limited;Great Wall Motor	长城汽车
Hailiang International Holdings Limited;Hailiang	海亮国际
United strength power holdings limited;United strength power	众诚能源
Weichai Power Co.,Ltd.;Weichai Power	潍柴动力
BeijingWest Industries International Limited;BeijingWest Industries	京西国际
Synergis Holdings Ltd.;Synergis	升捷控股
EcoGreen International Group Limited;EcoGreen	中怡国际
Comba Telecom Systems Holdings Ltd.;Comba Telecom Systems	京信通信
Pacific Basin Shipping Ltd.;Pacific Basin Shipping	太平洋航运
Shanghai Prime Machinery Company Limited;Shanghai Prime Machinery	上海集优
Dawnrays Pharmaceutical (Holdings) Ltd;Dawnrays Pharmaceutical	东瑞制药
China City Infrastructure Group Limited;China City Infrastructure	中国城市基础设施
Baoye Group Co. Limited;Baoye Group	宝业集团
Dah Sing Banking Group Ltd.;Dah Sing Banking	大新银行集团
AviChina Industry & Technology Company Limited;AviChina Industry & Technology	中航科工
Jiu Rong Holdings Limited;Jiu Rong	久融控股
Jinchuan Group International Resources Co. Ltd;Jinchuan Group International Resources	金川国际
Tongda Hong Tai Holdings Limited;Tongda Hong Tai	通达宏泰
SMI Culture & Travel Group Holdings Limited;SMI Culture & Travel	星美文化旅游
Eagle Nice (International) Holdings Ltd.;Eagle Nice	鹰美
Coolpad Group Limited;Coolpad	酷派集团
China Chuanglian Education Financial Group Limited;China Chuanglian Education Financial	创联教育金融
China Boqi Environmental (Holding) Co., Ltd.;China Boqi Environmental	博奇环保
Prudential plc;Prudential plc	保诚
Zhongtian International Ltd;Zhongtian	中天国际
China Power International Development Limited;China Power International Development	中国电力
Sunny Optical Technology (Group) Company Limited;Sunny Optical Technology	舜宇光学科技
TOM Group Ltd.;TOM Group	TOM集团
Sinopec Engineering (Group) Co., Ltd.;Sinopec Engineering	中石化炼化工程
BOC Hong Kong (Holdings) Limited;BOC Hong Kong	中银香港
Beijing Enterprises Medical and Health Industry Group Limited;Beijing Enterprises Medical and Health Industry	北控医疗健康
Yestar Healthcare Holdings Company Limited;Yestar Healthcare	巨星医疗控股
Good Friend International Holdings Inc;Good Friend International Holdings	友佳国际
China Fordoo Holdings Limited;China Fordoo	虎都
Space Group Holdings Limited;Space Group	恒宇集团
Launch Tech Company Limited;Launch Tech	元征科技
Hua Medicine;Hua Medicine	华领医药-B
BOC Aviation Limited;BOC Aviation	中银航空租赁
Aluminum Corporation of China Limited;Aluminum Corporation of China	中国铝业
China Pacific Insurance (Group) Co., Ltd.;China Pacific Insurance	中国太保
Shanghai Pharmaceuticals Holding Co.,Ltd;Shanghai Pharmaceuticals Holding	上海医药
Sunshine 100 China Holdings Ltd;Sunshine 100 China	阳光100中国
Guotai Junan Securities Co., Ltd.;Guotai Junan Securities	国泰君安
Add New Energy Investment Holdings Group Limited;Add New Energy Investment	爱德新能源
China Life Insurance Company Limited;China Life Insurance	中国人寿
Jacobson Pharma Corporation Limited;Jacobson Pharma	雅各臣科研制药
HK Electric Investments and HK Electric Investments Limited-SS;HK Electric Investments and HK Electric Investments	港灯-SS
Camsing International Holding Limited;Camsing	承兴国际控股
Kpa-Bm Holdings Limited;Kpa-Bm	应力控股
Genertec Universal Medical Group Company Limited;Genertec Universal Medical	环球医疗
Pak Tak International Ltd.;Pak Tak	百德国际
China Overseas Property Holdings Limited;China Overseas Property	中海物业
Texhong Textile Group Limited;Texhong Textile	天虹纺织
Innovax Holdings Limited;Innovax	创升控股
Wah Sun Handbags International Holdings Limited;Wah Sun Handbags	华新手袋国际控股
AAG Energy Holdings Limited;AAG Energy	亚美能源
ENN Energy Holdings Limited;ENN Energy	新奥能源
Nine Dragons Paper (Holdings) Limited;Nine Dragons Paper	玖龙纸业
Weiqiao Textile Company Limited;Weiqiao Textile	魏桥纺织
Xinming China Holdings Limited;Xinming China	新明中国
Green International Holdings Limited;Green International	格林国际控股
IBO Technology Company Limited;IBO Technology	艾伯科技
Chongqing Machinery & Electric Co., Ltd.;Chongqing Machinery & Electric	重庆机电
Shanghai Electric Group Company Limited;Shanghai Electric	上海电气
Yuhua Energy Holdings Limited;Yuhua Energy	裕华能源
Huajin International Holdings Limited;Huajin	华津国际控股
Jiayuan International Group Limited;Jiayuan	佳源国际控股
Guangzhou R&F Properties Co.,Ltd.;Guangzhou R&F Properties	富力地产
China Xinhua Education Group Limited;China Xinhua Education	中国新华教育
Yorkey Optical International (Cayman) Limited;Yorkey Optical International	精熙国际
Yuanda China Holdings limited;Yuanda China	远大中国
China Huarong Asset Management Co.,Ltd;China Huarong Asset Management	中国华融
Yixin Group Limited;Yixin Group	易鑫集团
Golden Faith Group Holdings Limited;Golden Faith	高丰集团控股
Cosco Shipping Development Company Limited;Cosco Shipping Development	中远海发
Beijing Capital Land Ltd.;Beijing Capital Land	首创置业
Greentown Service Group Co. Ltd.;Greentown Service	绿城服务
China Shineway Pharmaceutical Group Ltd;China Shineway Pharmaceutical	神威药业
Solomon Systech (International) Limited;Solomon Systech	SOLOMON SYSTECH
Dalian Port (PDA) Company Limited;Dalian Port (PDA)	大连港
Hong Kong Resources Holdings Company Limited;Hong Kong Resources	香港资源控股
China Oilfield Services Limited;China Oilfield Services	中海油田服务
Binhai Investment Company Limited;Binhai Investment	滨海投资
Standard Chartered Plc;Standard Chartered Plc	渣打集团
Nickel Resources International Holdings Company Limited;Nickel Resources International	镍资源国际
Longrun Tea Group Company Limited;Longrun Tea	龙润茶
Zijin Mining Group Company Limited;Zijin Mining	紫金矿业
China Wah Yan Healthcare Limited;China Wah Yan Healthcare	中国华仁医疗(旧)
Food Wise Holdings Limited;Food Wise	膳源控股(旧)
Anxian Yuan China Holdings Limited;Anxian Yuan China	安贤园中国(旧)
Qianhai Health Holdings Limited;Qianhai Health	前海健康(旧)
China Glass Holdings Limited;China Glass	中国玻璃
Ronshine China Holdings Limited;Ronshine China	融信中国
Kinergy Corporation Ltd.;Kinergy	光控精技
Jutal Offshore Oil Services Ltd.;Jutal Offshore Oil Services	巨涛海洋石油服务
Jnby Design Limited;Jnby Design	江南布衣
Golden Eagle Retail Group Ltd;Golden Eagle Retail	金鹰商贸集团
C-Mer Eye Care Holdings Limited;C-Mer Eye Care	希玛眼科
China State Construction International Holdings Limited;China State Construction	中国建筑国际
ArtGo Holdings Limited;ArtGo	雅高控股
Goldpac Group Limited;Goldpac	金邦达宝嘉
China Flavors and Fragrances Company Limited;China Flavors and Fragrances	中国香精香料
A-Living Services Co., Ltd.;A-Living Services	雅生活服务
China Resources Pharmaceutical Group Limited;China Resources Pharmaceutical	华润医药
Win Hanverky Holdings Limited;Win Hanverky	永嘉集团
China National Building Material Company Limited;China National Building Material	中国建材
Perfect Group International Holdings Limited;Perfect Group	保发集团
Bank of Communications Co.,Ltd.;Bank of Communications	交通银行
Bocom International Holdings Company Limited;Bocom International	交银国际
Lingbao Gold Group Company Ltd.;Lingbao Gold	灵宝黄金
Vinda International Holdings Ltd;Vinda International	维达国际
Nanjing Sinolife United Company Limited;Nanjing Sinolife United	中生联合
China Evergrande Group;China Evergrande	中国恒大
DBA Telecommunication (Asia) Holdings Limited;DBA Telecommunication	DBA电讯
Ju Teng International Holdings Ltd.;Ju Teng	巨腾国际
Anton Oilfield Services Group;Anton Oilfield Services	安东油田服务
Lonking Holdings Limited;Lonking	中国龙工
GTI Holdings Limited;GTI Holdings	共享集团
Advanced Semiconductor Manufacturing Corporation Limited;Advanced Semiconductor Manufacturing	先进半导体
Bestway Global Holding Inc.;Bestway Global Holding	荣威国际
Far East Horizon Limited;Far East Horizon	远东宏信
Zhengye International Holdings Company Limited;Zhengye International	正业国际
Overseas Chinese Town (Asia) Holdings Limited;Overseas Chinese Town	华侨城(亚洲)
Parkson Retail Group Limited;Parkson Retail	百盛集团
Qinhuangdao Port Co., Ltd.;Qinhuangdao Port	秦港股份
Sino-Ocean Group Holding Limited;Sino-Ocean	远洋集团
Xiamen International Port Co.,Ltd;Xiamen International Port	厦门港务
Logan Property Holdings Company Limited;Logan Property	龙光地产
Tianjin Port Development Holdings Limited;Tianjin Port Development	天津港发展
Agile Group Holdings Limited;Agile Group	雅居乐集团
Hengdeli Holdings Limited;Hengdeli	亨得利
Wasion Holdings Limited;Wasion	威胜控股
Persta Resources Inc.;Persta Resources	PERSTA
Legend Holdings Corporation;Legend Holdings	联想控股
China Ting Group Holdings Ltd;China Ting	华鼎控股
Guangdong Yueyun Transportation Company Limited;Guangdong Yueyun Transportation	粤运交通
Modern Dental Group Limited;Modern Dental	现代牙科
Fuyao Glass Industry Group Co.,Ltd;Fuyao Glass Industry Group	福耀玻璃
Yongsheng Advanced Materials Company Limited;Yongsheng Advanced Materials	永盛新材料
Beijing Tong Ren Tang Chinese Medicine Company Limited;Beijing Tong Ren Tang Chinese Medicine	同仁堂国药
Chongqing Rural Commercial Bank Co.,Ltd.;Chongqing Rural Commercial Bank	重庆农村商业银行
China Success Finance Group Holdings Limited;China Success Finance	中国金融发展
Hang Sang (Siu Po) International Holding Company Limited;Hang Sang (Siu Po)	HSSP INTL
Renheng Enterprise Holdings Limited;Renheng Enterprise	仁恒实业控股
Zhongyu Gas Holdings Limited;Zhongyu Gas	中裕燃气
Poly Culture Group Corporation Limited;Poly Culture Group	保利文化
Huabang Financial Holdings Limited;Huabang Financial	华邦金融
Yida China Holdings Limited;Yida China	亿达中国
Xiezhong International Holdings Limited;Xiezhong	协众国际控股
TANSH Global Food Group Co., Ltd;TANSH Global Food	国际天食
China Yongda Automobiles Services Holdings Limited;China Yongda Automobiles Services	永达汽车
Holly Futures Co.,Ltd;Holly Futures	弘业期货
Great Harvest Maeta Group Holdings Limited;Great Harvest Maeta	荣丰联合控股
Clifford Modern Living Holdings Limited;Clifford Modern Living	祈福生活服务
Top Spring International Holdings limited;Top Spring	莱蒙国际
Guangdong Kanghua Healthcare Co., Ltd.;Guangdong Kanghua Healthcare	康华医疗
Meituan Dianping;Meituan Dianping	美团点评-W
Huishang Bank Corporation Limited;Huishang Bank	徽商银行
Everbright Grand China Assets Limited;Everbright Grand China Assets	光大永年
Inke Limited;Inke	映客
Yat Sing Holdings Limited;Yat Sing	日成控股
Koradior Holdings Limited;Koradior	珂莱蒂尔
Ching Lee Holdings Limited;Ching Lee	正利控股
Zhongzhi Pharmaceutical Holdings Limited;Zhongzhi Pharmaceutical	中智药业
Vobile Group Limited;Vobile	阜博集团
Kunming Dianchi Water Treatment Co., Ltd.;Kunming Dianchi Water Treatment	滇池水务
NNK Group Limited;NNK Group	年年卡
China Fiber Optic Network System Group Ltd.;China Fiber Optic Network System	中国光纤
China Weaving Materials Holdings Limited;China Weaving Materials	中国织材控股
China Hanking Holdings Limited;China Hanking	中国罕王
Royal Deluxe Holdings Limited;Royal Deluxe	御佳控股
Dali Foods Group Company Limited;Dali Foods	达利食品
GCL-Poly Energy Holdings Limited;GCL-Poly Energy	保利协鑫能源
Sinotruk (Hong Kong) Limited;Sinotruk	中国重汽
Pou Sheng International (Holdings) Limited;Pou Sheng International	宝胜国际
KFM Kingdom Holdings Limited;KFM Kingdom	KFM金德
China Dongxiang (Group) Co., Ltd.;China Dongxiang	中国动向
Sam Woo Construction Group Limited;Sam Woo Construction	三和建筑集团
Tech Pro Technology Development Ltd;Tech Pro Technology Development	德普科技
Ming Fai International Holdings Limited;Ming Fai	明辉国际
Kiddieland International Limited;Kiddieland	童园国际
Xinjiang Xinxin Mining Industry Co., Ltd.;Xinjiang Xinxin Mining Industry	新疆新鑫矿业
China Harmony New Energy Auto Holding Limited;China Harmony New Energy Auto	和谐汽车
China Starch Holdings Ltd.;China Starch	中国淀粉
Chia Tai Enterprises International Limited;Chia Tai Enterprises	正大企业国际
Wealthy Way Group Limited;Wealthy Way	富道集团
Bank of Qingdao Co.,Ltd.;Bank of Qingdao	青岛银行
Hospital Corporation Of China Limited;Hospital Corporation Of China	弘和仁爱医疗
Vicon Holdings Limited;Vicon Holdings	VICON HOLDINGS
Sky Light Holdings Limited;Sky Light	天彩控股
China Aoyuan Property Group Limited;China Aoyuan Property	中国奥园
Town Health International Medical Group Limited;Town Health International Medical	康健国际医疗
Kingsoft Corporation Limited;Kingsoft	金山软件
Global Sweeteners Holdings Ltd.;Global Sweeteners	大成糖业
Crosstec Group Holdings Limited;Crosstec	易纬集团
Zhuzhou CRRC Times Electric Co., Ltd.;Zhuzhou CRRC Times Electric	中车时代电气
CIMC Enric Holdings Limited;CIMC Enric	中集安瑞科
Greentown China Holdings Limited;Greentown China	绿城中国
Hanhua Financial Holding Co.,Ltd.;Hanhua Financial Holding	瀚华金控
China International Capital Corporation Limited;China International Capital	中金公司
NagaCorp Ltd.;NagaCorp	金界控股
Golden Power Group Holdings Limited;Golden Power	金力集团
The United Laboratories International Holdings Ltd;United Laboratories	联邦制药
Wanguo International Mining Group Limited;Wanguo International Mining	万国国际矿业
Inner Mongolia Yitai Coal Co.,Ltd.;Inner Mongolia Yitai Coal	伊泰煤炭
Orient Securities Company Limited;Orient Securities	东方证券
China Rongzhong Financial Holdings Company Limited;China Rongzhong Financial	融众金融
China Baofeng (International) Limited;China Baofeng	中国宝丰国际
China Merchants Bank Co., Ltd.;China Merchants Bank	招商银行
China Railway Signal & Communication Corporation Limited;China Railway Signal & Communication	中国通号
China BlueChemical Ltd.;China BlueChemical	中海石油化学
Bank of China Limited;Bank of China	中国银行
Capital Environment Holdings Limited;Capital Environment	首创环境
China Molybdenum Co.,Ltd.;China Molybdenum	洛阳钼业
China Energy Engineering Corporation Limited;China Energy Engineering	中国能源建设
Telecom Service One Holdings Limited;Telecom Service One	电讯首科
Bosideng International Holdings Ltd.;Bosideng	波司登
DaChan Food (Asia) Limited;DaChan Food	大成食品
AMGEN INC;AMGEN	AMGEN-T
CISCO SYSTEMS, INC.;CISCO SYSTEMS	思科-T
INTEL CORP;INTEL CORP	英特尔-T
APPLIED MATERIALS INC /DE;APPLIED MATERIALS	应用材料-T
STARBUCKS CORP;STARBUCKS CORP	星巴克-T
MICROSOFT CORP;MICROSOFT CORP	微软-T
Bank of China Limited;Bank of China	BOC 2014 PREF
Industrial and Commercial Bank of China Limited;Industrial and Commercial Bank of China	ICBC USDPREF1
Industrial and Commercial Bank of China Limited;Industrial and Commercial Bank of China	ICBC EURPREF1
Bank of Communications Co.,Ltd.;Bank of Communications	BOCOM 15USDPREF
China Construction Bank Corporation;China Construction Bank	CCB 15USDPREF
China Cinda Asset Management Co.,Ltd.;China Cinda Asset Management	CINDA 16USDPREF
Huishang Bank Corporation Limited;Huishang Bank	HSBNK 16USDPREF
China Minsheng Banking Corp., Ltd.;China Minsheng Banking	CMBC 16USDPREF
China Zheshang Bank Co.,Ltd.;China Zheshang Bank	CZB 17USDPREF
Bank of Qingdao Co.,Ltd.;Bank of Qingdao	BQD 17USDPREF
Postal Savings Bank of China Co., Ltd.;Postal Savings Bank of China	PSBC 17USDPREF
Bank of Zhengzhou Co.,Ltd;Bank of Zhengzhou	ZZBNK 17USDPREF
China Merchants Bank Co., Ltd.;China Merchants Bank	CMB 17USDPREF
Bank of Jinzhou Co., Ltd.;Bank of Jinzhou	BOJZ 17USDPREF
Bank of Chongqing Co., Ltd.;Bank of Chongqing	BCQ 17USDPREF
CITIC Securities Company Limited;CITIC Securities	中信证券
Telecom Digital Holdings Limited;Telecom Digital	电讯数码控股
Apex Ace Holding Limited;Apex Ace	光丽科技
G&M Holdings Limited;G&M Holdings	信越控股
ZhongAn Online P&C Insurance Co.,Ltd.;ZhongAn Online P&C Insurance	众安在线
China Securities Co.,Ltd.;China Securities	中信建投证券
Wisdom Education International Holdings Company Limited;Wisdom Education International	睿见教育
Wing Chi Holdings Limited;Wing Chi	荣智控股
World-Link Logistics (Asia) Holding Limited;World-Link Logistics	环宇物流(亚洲)
Fit Hon Teng Limited;Fit Hon Teng	FIT HON TENG
Centurion Corporation Limited;Centurion	胜捷企业
Country Garden Services Holdings Company Limited;Country Garden Services	碧桂园服务
China Merchants Securities Co., Ltd;China Merchants Securities	招商证券
Wise Talent Information Technology Co., Ltd;Wise Talent Information Technology	有才天下猎聘
New Ray Medicine International Holding Limited;New Ray Medicine	新锐医药
Uts Marketing Solutions Holdings Limited;Uts Marketing Solutions	UTS MARKETING
Shanghai La Chapelle Fashion Co., Ltd.;Shanghai La Chapelle Fashion	拉夏贝尔
Austar Lifesciences Limited;Austar Lifesciences	奥星生命科技
Tian Yuan Group Holdings Limited;Tian Yuan	天源集团
Jilin Jiutai Rural Commercial Bank Corporation Limited;Jilin Jiutai Rural Commercial Bank	九台农商银行
YTO Express (International) Holdings Limited;YTO Express	圆通速递国际
Earthasia International Holdings Limited;Earthasia	泛亚国际
Vital Mobile Holdings Limited;Vital Mobile	维太移动
Kangda International Environmental Company Limited;Kangda International Environmental	康达环保
Harbin Bank Co.,Ltd.;Harbin Bank	哈尔滨银行
Jinmao Hotel & Jinmao (China) Hotel Investments and Management Limited-SS;Jinmao Hotel & Jinmao (China) Hotel Investments and Management	金茂酒店-SS
Zhenro Properties Group Limited;Zhenro Properties	正荣地产
BeiGene, Ltd.;BeiGene	百济神州-B
Target Insurance (Holdings) Limited;Target Insurance	泰加保险
Gemilang International Limited;Gemilang	彭顺国际
China VAST Industrial Urban Development Company Limited;China VAST Industrial Urban Development	中国宏泰发展
China U-Ton Holdings Limited;China U-Ton	中国优通
China Yuhua Education Corporation Limited;China Yuhua Education	宇华教育
Everbright Securities Company Limited;Everbright Securities	光大证券
Twintek Investment Holdings Limited;Twintek Investment	乙德投资控股
China Greenfresh Group Co., Ltd.;China Greenfresh	中国绿宝
Beijing Digital Telecom Co.,Ltd.;Beijing Digital Telecom	迪信通
Guangdong Adway Construction (Group) Holdings Company Limited;Guangdong Adway Construction	爱得威建设集团
Bank of Jiujiang Co.,Ltd.;Bank of Jiujiang	九江银行
Bank of Zhengzhou Co.,Ltd;Bank of Zhengzhou	郑州银行
Qingdao Port International Co., Ltd.;Qingdao Port	青岛港
Fast Retailing Co., Ltd.;Fast Retailing	FAST RETAIL-DRS
Sun Art Retail Group Limited;Sun Art Retail	高鑫零售
Prosper Construction Holdings Limited;Prosper Construction	瑞港建设
China Everbright Bank Company Limited;China Everbright Bank	中国光大银行
King's Flair International (Holdings) Limited;King's Flair International	科劲国际
HKT Trust and HKT Ltd.-SS;HKT Trust and HKT	香港电讯-SS
Shanghai Haohai Biological Technology Co., Ltd.;Shanghai Haohai Biological Technology	昊海生物科技
Beijing Gas Blue Sky Holdings Limited;Beijing Gas Blue Sky	北京燃气蓝天
Dragon Rise Group Holdings Limited;Dragon Rise	龙升集团控股
Huazhong In-Vehicle Holdings Company Limited;Huazhong In-Vehicle	华众车载
Sinco Pharmaceuticals Holdings Limited;Sinco Pharmaceuticals	兴科蓉医药
Tianyun International Holdings Limited;Tianyun	天韵国际控股
Haitong Securities Co., Ltd.;Haitong Securities	海通证券
Winox Holdings limited;Winox Holdings	盈利时
Yunnan Water Investment Co., Limited;Yunnan Water Investment	云南水务
Honma Golf Limited;Honma Golf	本间高尔夫
Finger Tango Inc.;Finger Tango	指尖悦动
China Huishan Dairy Holdings Company Limited;China Huishan Dairy	辉山乳业
Flat Glass Group Co., Ltd.;Flat Glass	福莱特玻璃
Zuoli Kechuang Micro-finance Company Limited;Zuoli Kechuang Micro-finance	佐力小贷
Tenfu (Cayman) Holdings Company Limited;Tenfu	天福
Yangtze Optical Fibre and Cable Joint Stock Limited Company;Yangtze Optical Fibre and Cable Joint Stock	长飞光纤光缆
KVB Kunlun Financial Group Limited;KVB Kunlun Financial	昆仑国际金融
Differ Group Holding Company Limited;Differ Group Holding	鼎丰集团控股
Tempus Holdings Limited;Tempus	腾邦控股
China Galaxy Securities Co.,Ltd.;China Galaxy Securities	中国银河
EGL Holdings Company Limited;EGL Holdings	东瀛游
Henan Jinma Energy Company Limited;Henan Jinma Energy	金马能源
Huatai Securities Co.,Ltd.;Huatai Securities	HTSC
Freetech Road Recycling Technology (Holdings) Limited;Freetech Road Recycling Technology	英达公路再生科技
Dynam Japan Holdings Co.,Ltd.;Dynam Japan Holdings	DYNAM JAPAN
Hin Sang Group (International) Holding Co. Ltd.;Hin Sang Group	衍生集团
Golden Throat Holdings Group Company Limited;Golden Throat Holdings	金嗓子
China Aluminum Cans Holdings Limited;China Aluminum Cans	中国铝罐
Ourgame International Holdings Limited;Ourgame	联众
Orient Securities International Holdings Limited;Orient Securities	东方汇财证券
Great World Company Holdings Ltd;Great World	世大控股
Yuxing InfoTech Investment Holdings Limited;Yuxing InfoTech Investment	裕兴科技
Sino Splendid Holdings Limited;Sino Splendid	华泰瑞银
Global Strategic Group Limited;Global Strategic	环球战略集团
Chinese Energy Holdings Limited;Chinese Energy	华夏能源控股
Polyard Petroleum International Group Limited;Polyard Petroleum	百田石油
ECI Technology Holdings Limited;ECI Technology	ECI TECH
Changhong Jiahua Holdings Limited;Changhong Jiahua	长虹佳华
Finsoft Financial Investment Holdings Limited;Finsoft Financial Investment	汇财金融投资
Hao Wen Holdings Limited;Hao Wen	皓文控股
Unitas Holdings Limited;Unitas	宏海控股集团
WLS Holdings Ltd.;WLS Holdings	汇隆控股
Evershine Group Holdings Limited;Evershine	永耀集团控股
Kwong Man Kee Group Limited;Kwong Man Kee	邝文记
Asian Capital Resources (Holdings) Limited;Asian Capital Resources	亚洲资产
China Brilliant Global Limited;China Brilliant Global	朗华国际集团
KPM Holding Limited;KPM Holdings	吉辉控股
Timeless Software Limited;Timeless Software	天时软件
Sun International Group Limited;Sun International	太阳国际
Flying Financial Service Holdings Limited;Flying Financial Service	汇联金融服务
ETS Group Limited;ETS Group	易通讯集团
Viva China Holdings Limited;Viva China	非凡中国
Vodatel Networks Holdings Limited;Vodatel Networks	爱达利网络
Janco Holdings Limited;Janco Holdings	骏高控股
China Biotech Services Holdings Limited;China Biotech Services	中国生物科技服务
KNK Holdings Limited;KNK Holdings	中国卓银
DCB Holdings Limited;DCB Holdings	DCB控股
Luxey International (Holdings) Limited;Luxey International	荟萃国际(控股)
Atlinks Group Limited;Atlinks	ATLINKS
Jiangsu NandaSoft Technology Company Limited;Jiangsu NandaSoft Technology	南大苏富特
Heng Xin China Holdings Limited;Heng Xin China	恒芯中国
China Ocean Fishing Holdings Limited;China Ocean Fishing	中国海洋捕捞
Yu Tak International Holdings Limited;YuTak	御德国际控股
Jilin Province Huinan Changlong Bio-pharmacy Company Limited;Jilin Province Huinan Changlong Bio-pharmacy	吉林长龙药业
Quantum Thinking Limited;Quantum Thinking	量子思维
CircuTech International Holdings Limited;CircuTech	讯智海
Luk Hing Entertainment Group Holdings Limited;Luk Hing Entertainment	陆庆娱乐
Pizu Group Holdings Limited;Pizu Group	比优集团
China E-Information Technology Group Limited;China E-Information Technology	中国网络信息科技
Dining Concepts Holdings Limited;Dining Concepts	饮食概念
Madison Holdings Group Limited;Madison Holdings	麦迪森控股
Glory Flame Holdings Limited;Glory Flame	朝威控股
Global Link Communications Holdings Ltd;Global Link Communications	国联通信
Eft Solutions Holdings Limited;Eft Solutions	俊盟国际
Global Mastermind Holdings Limited;Global Mastermind	环球大通集团
Kml Technology Group Limited;Kml Technology	高萌科技
Phoenitron Holdings Limited;Phoenitron	品创控股
Oriental University City Holdings (H.K.) Limited;Oriental University City Holdings	东方大学城控股
Wwpkg Holdings Company Limited;Wwpkg Holdings	纵横游控股
Keen Ocean International Holding Limited;Keen Ocean	侨洋国际控股
China Netcom Technology Holdings Limited;China Netcom Technology	中彩网通控股
Roma Group Limited;Roma Group	罗马集团
China Singyes New Materials Holdings Limited;China Singyes New Materials	兴业新材料
Hopewell Highway Infrastructure Ltd.;Hopewell Highway Infrastructure	合和公路基建-R
Media Asia Group Holdings Limited;Media Asia	寰亚传媒
Sing Lee Software (Group) Limited;Sing Lee Software	新利软件
HMV Digital China Group Limited;HMV Digital China	HMV数码中国
Easy Repay Finance & Investment Limited;Easy Repay Finance & Investment	易还财务投资
North Asia Strategic Holdings Limited;North Asia Strategic	北亚策略
Interactive Entertainment China Cultural Technology Investments Limited;Interactive Entertainment China Cultural Technology Investments	互娱中国
Sage International Group Limited;Sage International	仁智国际集团
China Youzan Limited;China Youzan	中国有赞
Hong Kong Life Sciences and Technologies Group Limited;Hong Kong Life Sciences and Technologies	香港生命科学
Sino Vision Worldwide Holdings Limited;Sino Vision Worldwide	新维国际控股
China 33 Media Group limited;China 33 Media	中国三三传媒
AID Life Science Holdings Limited;AID Life Science	汇友生命科学
Chinese Strategic Holdings Limited;Chinese Strategic	华人策略控股
China Assurance Finance Group Limited;China Assurance Finance	中国融保金融集团
Ooh Holdings Limited;Ooh Holdings	奥传思维控股
ITE (Holdings) Limited;ITE Holdings	ITE HOLDINGS
Million Stars Holdings Limited;Million Stars	万星控股
Beijing Beida Jade Bird Universal Sci-Tech Co. Ltd.;Beijing Beida Jade Bird Universal Sci-Tech	北大青鸟环宇
CL Group (Holdings) limited;CL Group	昌利控股
GET Holdings Limited;GET Holdings	智易控股
EJE (Hong Kong) Holdings Limited;EJE	壹家壹品
Trillion Grand Corporate Company Limited;Trillion Grand Corporate	万泰企业股份
Kingsley Edugroup Limited;Kingsley Edugroup	皇岦
Shenghua Lande Scitech Limited;Shenghua Lande Scitech	升华兰德
Vision International Holdings Limited;Vision International	威诚国际控股
Grand Peace Group Holdings Limited;Grand Peace	福泽集团
Kirin Group Holdings Limited;Kirin Group	麒麟集团控股
China Technology Solar Power Holdings Limited;China Technology Solar Power	中科光电
Cornerstone Financial Holdings Limited;Cornerstone Financial	基石金融
Hi-Level Technology Holdings Limited;Hi-Level Technology	扬宇科技
Shanghai Qingpu Fire-Fighting Equipment Co. Limited;Shanghai Qingpu Fire-Fighting Equipment	上海青浦消防
China Fortune Investments (Holding) Limited;China Fortune Investments	中国幸福投资
China Primary Energy Holdings Limited;China Primary Energy	中国基础能源
Bortex Global Limited;Bortex Global	濠亮环球
Thiz Technology Group Ltd.;Thiz Technology	即时科研
China Demeter Financial Investments Limited;China Demeter Financial Investments	国农金融投资
Guru Online (Holdings) Limited;Guru Online	超凡网络
Sinofortune Financial Holdings Limited;Sinofortune Financial	华亿金控
Royal Century Resources Holdings Limited;Royal Century Resources	仁德资源
G.A. Holdings Limited;G.A.	G﹒A﹒控股
China Geothermal Industry Development Group Limited;China Geothermal Industry Development	中国地热能
Cloud Investment Holdings Limited;Cloud Investment	云信投资控股
Zhi Cheng Holdings Limited;Zhi Cheng	智城控股
abc Multiactive Limited;abc Multiactive	辰罡科技
China Oil Gangran Energy Group Holdings Limited;China Oil Gangran Energy	中油港燃
Jete Power Holdings Limited;Jete Power	铸能控股
ZMFY Automobile Glass Services Limited;ZMFY Automobile Glass Services	正美丰业
IMS Group Holdings Limited;IMS Group	英马斯集团
Honbridge Holdings Limited;Honbridge	洪桥集团
Zhejiang Chang'An Renheng Technology Co., Ltd.;Zhejiang Chang'An Renheng Technology	长安仁恒
BOSA Technology Holdings Limited;BOSA Technology	人和科技
Tak Lee Machinery Holdings Limited;Tak Lee Machinery	德利机械
Hua Xia Healthcare Holdings Limited;Hua Xia Healthcare	华夏医疗
Grace Wine Holdings Limited;Grace Wine	怡园酒业
Millennium Pacific Group Holdings Limited;Millennium Pacific	汇思太平洋
Aurum Pacific (China) Group Limited;Aurum Pacific	奥栢中国
Altus Holdings Limited;Altus Holdings	浩德控股
Seamless Green China (Holdings) Limited;Seamless Green China	无缝绿色
Bao Shen Holdings Limited;Bao Shen	宝申控股
M&L Holdings Group Limited;M&L Holdings	明梁控股
Code Agriculture (Holdings) Limited;Code Agriculture	科地农业
South China Assets Holdings Limited;South China Assets	南华资产控股
China Vanguard You Champion Holdings Limited;China Vanguard You Champion	众彩股份
Xiangxing International Holding Limited;Xiangxing	象兴国际
China Regenerative Medicine International Limited;China Regenerative Medicine	中国再生医学
Glory Mark Hi-Tech (Holdings) Ltd.;Glory Mark Hi-Tech	辉煌科技
Goldway Education Group Limited;Goldway Education	GOLDWAY EDU
Medinet Group Limited;Medinet	医汇集团
Loco Hong Kong Holdings Limited;Loco Hong Kong	港银控股
Merdeka Financial Services Group Limited;Merdeka Financial Services	万德金融
Jian ePayment Systems Ltd.;Jian ePayment Systems	华普智通
China Eco-Farming Limited;China Eco-Farming	中国农业生态
Neo Telemedia Limited;Neo Telemedia	中国新电信
Amasse Capital Holdings Limited;Amasse Capital	宝积资本
Eco-Tek Holdings Ltd.;Eco-Tek	环康集团
KSL Holdings Limited;KSL Holdings	KSL HOLDINGS
China Trends Holdings Limited;China Trends	中国趋势
Lajin Entertainment Network Group Limited;Lajin Entertainment Network	拉近网娱
Union Asia Enterprise Holdings Limited;Union Asia Enterprise	万亚企业控股
China Digital Culture (Group) Limited;China Digital Culture	中国数码文化
SuperRobotics Limited;SuperRobotics	超人智能
China Information Technology Development Limited;China Information Technology Development	中国信息科技
Food Idea Holdings Limited;Food Idea	新煮意控股
Heng Sheng Holdings Limited;Heng Sheng	恒生控股有限公司
China Candy Holdings Limited;China Candy	中国糖果
Speed Apparel Holding Limited;Speed Apparel	尚捷集团控股
IR Resources Limited;IR Resources	同仁资源
Jimu Group Limited;Jimu Group	积木集团
Gme Group Holdings Limited;Gme Group	骏杰集团控股
Tianjin TEDA Biomedical Engineering Company Limited;Tianjin TEDA Biomedical Engineering	泰达生物
Combest Holdings Limited;Combest	康佰控股
Hong Wei (Asia) Holdings Company Limited;Hong Wei	鸿伟亚洲
Global Energy Resources International Group Limited;Global Energy Resources	环球能源资源
Greaterchina Professional Services Limited;Greaterchina Professional Services	汉华专业服务
L&A International Holdings Limited;L&A International	L&A INTL HOLD
Great Water Holdings Limited;Great Water	建禹集团
Baytacare Pharmaceutical Co., Ltd.;Baytacare Pharmaceutical	北斗嘉药业
Loto Interactive Limited;Loto Interactive	乐透互娱
China Wan Tong Yuan (Holdings) Limited;China Wan Tong Yuan	中国万桐园
Sau San Tong Holdings Limited;Sau San Tong	修身堂
PPS International (Holdings) Limited;PPS International	宝联控股
Inno-Tech Holdings Ltd.;Inno-Tech	汇创控股
Kaisun Holdings Limited;Kaisun	凯顺控股
Shanghai Jiaoda Withub Information Industrial Co Ltd;Shanghai Jiaoda Withub Information Industrial	交大慧谷
Shentong Robot Education Group Company Limited;Shentong Robot Education	神通机器人教育
Chong Sing Holdings FinTech Group Limited;Chong Sing Holdings FinTech	中新控股
DLC Asia Limited;DLC Asia	衍汇亚洲
Zhejiang Yongan Rongtong Holdings Co., Ltd.;Zhejiang Yongan Rongtong	浙江永安
Celebrate International Holdings Limited;Celebrate	誉满国际控股
New Wisdom Holding Company Limited;New Wisdom Holding	新智控股
First Credit Finance Group Limited;First Credit Finance	FIRST CREDIT
Luen Wong Group Holdings Limited;Luen Wong	联旺集团
Echo International Holdings Group Limited;Echo International	毅高国际控股
Hanvey Group Holdings Limited;Hanvey	恒伟集团控股
Bingo Group Holdings Limited;Bingo Group	比高集团
PF Group Holdings Limited;PF Group	PF GROUP
E Lighting Group Holdings Limited;E Lighting	壹照明
Ziyuanyuan Holdings Group Limited;Ziyuanyuan	紫元元
China Health Group Inc.;China Health Group	中国医疗集团
KOALA Financial Group Limited;KOALA Financial	树熊金融集团
Xi'an Haitiantian Holdings Co., Ltd.;Xi'an Haitiantian	西安海天天
National Arts Entertainment and Culture Group Limited;National Arts Entertainment and Culture	国艺娱乐
Future Data Group Limited;Future Data	FUTURE DATA
China Yu Tian Holdings Limited;China Yu Tian	中国宇天
PFC Device Inc.;PFC Device	节能元件
Classified Group (Holdings) Limited;Classified	CLASSIFIED GP
CCID Consulting Co. Limited;CCID Consulting	赛迪顾问
Powerleader Science & Technology Group Limited;Powerleader Science & Technology	宝德科技集团
Link Holdings Limited;Link Holdings	华星控股
Winto Group (Holdings) Limited;Winto Group	惠陶集团
Capital Finance Holdings Limited;Capital Finance	首都金融控股
Goal Forward Holdings Limited;Goal Forward	展程控股
Ying Kee Tea House Group Limited;Ying Kee Tea House	英记茶庄集团
New Western Group Limited;New Western	新威斯顿
Dahe Media Co.,Ltd.;Dahe Media	大贺传媒
On Real International Holdings Limited;On Real	安悦国际控股
Zhonghua Gas Holdings Limited;Zhonghua Gas	北方新能源
Biosino Bio-technology and Science Incorporation;Biosino Bio-technology and Science Incorporation	中生北控生物科技
Zhejiang Rui Yuan Intelligent Control Technology Company Limited;Zhejiang Rui Yuan Intelligent Control Technology	瑞远智控
Silk Road Energy Services Group Limited;Silk Road Energy Services	丝路能源
A.Plus Group Holdings Limited;A.Plus	优越集团控股
Yangzhou Guangling District Taihe Rural Micro-Finance Company Limited;Yangzhou Guangling District Taihe Rural Micro-Finance	泰和小贷
China Binary Sale Technology Limited;China Binary Sale Technology	神州数字
Netel Technology (Holdings) Ltd.;Netel Technology	金利通
Genes Tech Group Holdings Company Limited;Genes Tech	靖洋集团
Shaanxi Northwest New Technology Industry Co. Limited;Shaanxi Northwest New Technology Industry	西北实业
Yin He Holdings Limited;YinHe Holdings	银合控股
Super Strong Holdings Limited;Super Strong	宏强控股
China Trustful Group Limited;China Trustful	中国之信集团
Zhuoxin International Holdings Limited;Zhuoxin	卓信国际控股
Linekong Interactive Group Co., Ltd.;Linekong Interactive	蓝港互动
Deson Construction International Holdings Limited;Deson Construction	迪臣建设
Wealth Glory Holdings limited;Wealth Glory	富誉控股
China CBM Group Company Limited;China CBM	中国煤层气
Global Digital Creations Holdings Limited;Global Digital Creations	环球数码创意
Chinese Food and Beverage Group Limited;Chinese Food and Beverage	华人饮食集团
Zhejiang Prospect Company Limited;Zhejiang Prospect	浙江展望
Beaver Group (Holding) Company Limited;Beaver Group	永勤集团控股
Steed Oriental (Holdings) Company Limited;Steed Oriental	骏东控股
Cmon Limited;Cmon	CMON
AGTech Holdings Limited;AGTech	亚博科技控股
China Digital Video Holdings Limited;China Digital Video	中国数字视频
China Golden Classic Group Limited;China Golden Classic	中国金典集团
Gameone Holdings Limited;Gameone	智傲控股
Zheng Li Holdings Limited;Zheng Li	正力控股
Sling Group Holdings Limited;Sling Group	森浩集团
Shanxi Changcheng Microlight Equipment Co. Limited;Shanxi Changcheng Microlight Equipment	长城微光
Zioncom Holdings Limited;Zioncom	ZIONCOM
Ahsay Backup Software Development Company Limited;Ahsay Backup Software Development	亚势备份
Wan Cheng Metal Packaging Company Limited;Wan Cheng Metal Packaging	万成金属包装
Worldgate Global Logistics Ltd;Worldgate Global Logistics	盛良物流
Singasia Holdings Limited;Singasia	星亚控股
ZZ Capital International Limited;ZZ Capital	中植资本国际
Sino-Life Group Limited;Sino-Life	中国生命集团
My Heart Bodibra Group Limited;My Heart Bodibra	芭迪贝伊
Grand T G Gold Holdings Limited;Grand T G Gold	大唐潼金
Royal Catering Group Holdings Company Limited;Royal Catering	皇玺餐饮集团
Shenzhen Mingwah Aohan High Technology Corp. Limited;Shenzhen Mingwah Aohan High Technology	明华科技
Tong Kee (Holding) Limited;Tong Kee	棠记控股
China Nonferrous Metals Company Limited;China Nonferrous Metals	中国有色金属
Medicskin Holdings Limited;Medicskin	密迪斯肌
Gudou Holdings Limited;Gudou Holdings	古兜控股
Man Shing Global Holdings Limited;Man Shing Global	万成环球控股
Dafeng Port Heshun Technology Company Limited;Dafeng Port Heshun Technology	大丰港
Perfect Optronics Limited;Perfect Optronics	圆美光电
China Hanya Group Holdings Limited;China Hanya	中国瀚亚
Zacd Group Ltd.;Zacd	杰地集团
King Force Group Holdings Limited;King Force	冠辉集团控股
Pak Wing Group (Holdings) Limited;Pak Wing	柏荣集团控股
Finet Group Limited;Finet Group	财华社集团
Expert Systems Holdings Limited;Expert Systems	思博系统
Allied Sustainability And Environmental Consultants Group Limited;Allied Sustainability And Environmental Consultants	沛然环保
Tai Kam Holdings Limited;Tai Kam	泰锦控股
China Smartpay Group Holdings Limited;China Smartpay	中国支付通
Tonking New Energy Group Holdings Limited;Tonking New Energy	同景新能源
Xinyi Automobile Glass Hong Kong Enterprises Limited;Xinyi Automobile Glass Hong Kong Enterprises	信义香港
Shenzhen Neptunus Interlong Bio-Technique Company Limited;Shenzhen Neptunus Interlong Bio-Technique	海王英特龙
HangKan Group Limited;HangKan	恒勤集团
Astrum Financial Holdings Limited;Astrum Financial	阿仕特朗金融
Directel Holdings Limited;Directel	直通电讯
Vinco Finacial Group Limited;Vinco Finacial	域高金融
Aesoholdinglimited;Aesoholdinglimited	艾硕控股
Vixtel Technologies Holdings Limited;Vixtel Technologies	飞思达科技
Hongguang Lighting Holdings Company Limited;Hongguang Lighting	宏光照明
Fire Rock Holdings Limited;Fire Rock	火岩控股
Tem Holdings Limited;Tem Holdings	创新电子控股
F8 Enterprises (Holdings) Group Limited;F8 Enterprises	F8企业
Tianjin Binhai Teda Logistics (Group) Corporation Limited;Tianjin Binhai Teda Logistics	滨海泰达物流
Meigu Technology Holding Group Limited;Meigu Technology	美固科技控股
Excalibur Global Financial Holdings Limited;Excalibur Global Financial	骏溢环球金融
Larry Jewelry International Company Limited;Larry Jewelry International	俊文宝石
Anacle Systems Limited;Anacle Systems	安科系统
i-Control Holdings Limited;i-Control	超智能控股
CNC Holdings Limited;CNC Holdings	中国新华电视
Republic Healthcare Limited;Republic Healthcare	REPUBLIC HC
Miricor Enterprises Holdings Limited;Miricor Enterprises	卓珈控股
Hypebeast Limited;Hypebeast	HYPEBEAST
AL Group Limited;AL Group	利骏集团香港
China Parenting Network Holdings Limited;China Parenting Network	中国育儿网络
Winning Tower Group Holdings Limited;Winning Tower	运兴泰集团
SDM Group Holdings Limited;SDM Group	SDM GROUP
Vbg International Holdings Limited;Vbg International	建泉国际控股
Zhejiang United Investment Holdings Group Limited;Zhejiang United Investment	浙江联合投资
Simplicity Holding Limited;Simplicity	倩碧控股
Creative China Holdings Limited;Creative China	中国创意控股
Zhi Sheng Group Holdings Limited;Zhi Sheng	智升集团控股
Taste · Gourmet Group Limited;Taste · Gourmet	尝高美集团
Grand Brilliance Group Holdings Limited;Grand Brilliance	君百延集团
Indigo Star Holdings Limited;Indigo Star	靛蓝星
Vertical International Holdings Limited;Vertical	弘浩国际控股
Fineland Real Estate Services Group Limited;Fineland Real Estate Services	方圆房服集团
Shen You Holdings Limited;Shen You	申酉控股
Prime Intelligence Solutions Group Limited;Prime Intelligence Solutions	汇安智能
Linocraft Holdings Limited;Linocraft	东骏控股
Prosperous Printing Company Limited;Prosperous Printing	万里印刷
Elegance Commercial and Financial Printing Group Limited;Elegance Commercial and Financial Printing	精雅印刷集团
Satu Holdings Limited;Satu Holdings	舍图控股
Tree Holdings Limited;Tree Holdings	齐家控股
Asia Pioneer Entertainment Holdings Limited;Asia Pioneer Entertainment	亚洲先锋娱乐
Stream Ideas Group Limited;Stream Ideas	源想集团
Gt Steel Construction Group Limited;Gt Steel Construction	GT STEEL GROUP
Dowway Holdings Limited;Dowway	天平道合
Hang Chi Holdings Limited;Hang Chi	恒智控股
Alpha Era International Holdings Limited;Alpha Era	合宝丰年
China Industrial Securities International Financial Group Limited;China Industrial Securities International Financial	兴证国际
Windmill Group Limited;Windmill	海鑫集团
Edvance International Holdings Limited;Edvance	安领国际
K W Nelson Interior Design and Contracting Group Limited;K W Nelson Interior Design and Contracting	K W NELSON GP
BCI Group Holdings Limited;BCI Group	高门集团
Asia Grocery Distribution Limited;Asia Grocery Distribution	亚洲杂货
LKS Holding Group Limited;LKS Holdings	乐嘉思控股
Hm International Holdings Limited;Hm International	HM INTL HLDGS
Dadi Education Holdings Limited;Dadi Education	大地教育
AV Promotions Holdings Limited;AV Promotions	AV策划推广
Nexion Technologies Limited;Nexion Technologies	NEXION TECH
Winson Holdings Hong Kong Limited;Winson Holdings Hong Kong	永顺控股香港
WT Group Holdings Limited;WT Group	WT集团
Chi Ho Development Holdings Limited;Chi Ho Development	CHI HO DEV
Hing Ming Holdings Limited;Hing Ming	兴铭控股
Modern Living Investments Holdings Limited;Modern Living Investments	雅居投资控股
Sk Target Group Limited;Sk Target	瑞强集团
CBK Holdings Limited;CBK Holdings	国茂控股
Icicle Group Holdings Limited;Icicle	冰雪集团
C&N Holdings Limited;C&N Holdings	春能控股
Hao Bai International (Cayman) Limited;Hao Bai International	浩柏国际
Bar Pacific Group Holdings Limited;Bar Pacific	太平洋酒吧
Takbo Group Holdings Limited;Takbo Group	德宝集团控股
Rmh Holdings Limited;Rmh Holdings	德斯控股
Somerley Capital Holdings Limited;Somerley Capital	新百利融资
Sg Group Holdings Limited;Sg Group	桦欣控股
Noble Engineering Group Holdings Limited;Noble Engineering	怡康泰工程集团
In Technical Productions Holdings Limited;In Technical Productions	ITP HOLDINGS
Ms Concept Limited;Ms Concept	MS CONCEPT
Universe Printshop Holdings Limited;Universe Printshop	环球印馆
EDICO Holdings Limited;EDICO	钜京控股
Sunlight (1977) Holdings Limited;Sunlight (1977)	日光控股
Fy Financial (Shenzhen) Co.,Ltd.;Fy Financial (Shenzhen)	富银融资股份
Lai Group Holding Company Limited;Lai Group Holding	礼建德集团
Mansion International Holdings Limited;Mansion	民信国际控股
Goal Rise Logistics (China) Holdings Limited;Goal Rise Logistics	健升物流中国
Basetrophy Group Holdings Limited;Basetrophy	基地锦标集团
Industrial and Commercial Bank of China Limited;Industrial and Commercial Bank of China	ICBC CNHPREF1-R
Omnibridge Holdings Limited;Omnibridge	桥英控股
Tomo Holdings Limited;Tomo Holdings	TOMO HOLDINGS
Transtech Optelecom Science Holdings Limited;Transtech Optelecom Science	高科桥
Sheng Ye Capital Limitde;Sheng Ye Capital Limitde	盛业资本
Lumina Group Limited;Lumina	莹岚集团
Reach New Holdings Limited;Reach New	新达控股
Lapco Holdings Limited;Lapco	立高控股
Mi Ming Mart Holdings Limited;Mi Ming Mart	弥明生活百货
K Group Holdings Limited;K Group	千盛集团控股
Ocean One Holding Ltd.;Ocean One	大洋环球控股
JTF International Holdings Limited;JTF International	金泰丰国际控股
Furniweb Holdings Limited;Furniweb	飞霓控股
Shenglong Splendecor International Limited;Shenglong Splendecor	盛龙锦秀国际
Wan Leader International Limited;Wan Leader	万励达
Max Sight Group Holdings Limited;Max Sight	名仕快相
Smart Globe Holdings Limited;Smart Globe	竣球控股
ISP Global Limited;ISP Global	ISP GLOBAL
Niche-Tech Group Limited;Niche-Tech	骏码科技
Cool Link (Holdings) Limited;Cool Link	COOL LINK
Dragon King Group Holdings Limited;Dragon King	龙皇集团
1957 & Co.(Hospitality) Limited;1957 & Co.(Hospitality)	1957 & CO.
Sanbase Corporation Limited;Sanbase	庄皇集团公司
Ocean Line Port Development Limited;Ocean Line Port Development	远航港口
China Futex Holdings Limited;China Futex	福纺控股
I.Century Holding Limited;I.Century	爱世纪集团
Wine's Link International Holdings Limited;Wine's Link	威扬酒业控股
Top Standard Corporation;Top Standard	TOPSTANDARDCORP
Zhicheng Technology Group Ltd.;Zhicheng Technology	ZC TECH GP
Hyfusin Group Holdings Limited;Hyfusin	凯富善集团控股
IAG Holdings Limited;IAG Holdings	迎宏控股
Jia Group Holdings Limited;Jia Group	JIA GROUP
ST International Holdings Company Limited;ST International	智纺国际控股
Gain Plus Holdings Limited;Gain Plus	德益控股
Sheung Moon Holdings Limited;Sheung Moon	常满控股
Byleasing Holdings Limited;Byleasing	百应租赁
Wing Fung Group Asia Limited;Wing Fung Group Asia	荣丰集团亚洲
Jlogo Holdings Limited;Jlogo	聚利宝控股
Polyfair Holdings Limited;Polyfair	宝发控股
Vistar Holdings Limited;Vistar	荧德控股
TL Natural Gas Holdings Limited;TL Natural Gas	TL NATURAL GAS
Victory Securities (Holdings) Company Limited;Victory Securities	胜利证券
Amuse Group Holding Limited;Amuse Group	佰悦集团
Pacific Legend Group Limited;Pacific Legend	PACIFIC LEGEND
King Force Group Holdings Limited;King Force	冠辉集团控股
Boltek Holdings Limited;Boltek	宝燵控股
Kinetix Systems Holdings Limited;Kinetix Systems	倢冠控股
Eggriculture Foods Ltd.;Eggriculture Foods	永续农业
WAC Holdings Limited;WAC Holdings	WAC HOLDINGS